American: [a, me, ri, can]
Brown: [brown]
Christian: [chri, stian]
Congress: [con, gress]
Doctor: [do, ctor]
England: [en, gland]
English: [en, glish]
Europe: [eu, rope]
French: [french]
God: [god]
I: [i]
John: [john]
Mister: [mi, ster]
Mr: []
Mrs: []
a: [a]
abilities: [a, bi, li, ties]
ability: [a, bi, li, ty]
ability's: [a, bi, li, tys]
able: [a, ble]
about: [a, bout]
above: [a, bove]
absence: [a, bsen, ce]
absolute: [a, bso, lute]
absolutely: [a, bso, lu, te, ly]
abuse: [a, buse]
academic: [a, ca, de, mic]
accept: [a, ccept]
acceptable: [a, cce, pta, ble]
accepted: [a, cce, pted]
accepting: [a, cce, pting]
accepts: [a, ccepts]
access: [a, ccess]
accessible: [a, cce, ssi, ble]
accident: [a, cci, dent]
accidental: [a, cci, den, tal]
accidentally: [a, cci, den, ta, lly]
accord: [a, ccord]
accorded: [a, ccor, ded]
according: [a, ccor, ding]
accordingly: [a, ccor, din, gly]
accords: [a, ccords]
account: [a, ccount]
account's: [a, ccounts]
accounts: [a, ccounts]
accuracy: [a, ccu, ra, cy]
accurate: [a, ccu, rate]
achieve: [a, chieve]
achieved: [a, chie, ved]
achieves: [a, chie, ves]
achieving: [a, chie, ving]
acquire: [a, cquire]
acquired: [a, cqui, red]
acquires: [a, cqui, res]
acquiring: [a, cqui, ring]
across: [a, cross]
act: [act]
act's: [acts]
acted: [a, cted]
acting: [a, cting]
action: [a, ction]
action's: [a, ctions]
actions: [a, ctions]
active: [a, ctive]
activities: [a, cti, vi, ties]
activity: [a, cti, vi, ty]
activity's: [a, cti, vi, tys]
acts: [acts]
actual: [a, ctual]
actually: [a, ctua, lly]
add: [add]
added: [a, dded]
adding: [a, dding]
addition: [a, ddi, tion]
additional: [a, ddi, tio, nal]
address: [a, ddress]
address's: [a, ddresss]
addressed: [a, ddre, ssed]
addresses: [a, ddre, sses]
addressing: [a, ddre, ssing]
adds: [adds]
adequate: [a, de, quate]
adjust: [a, djust]
administration: [a, dmi, ni, stra, tion]
admit: [a, dmit]
admits: [a, dmits]
admitted: [a, dmi, tted]
admittedly: [a, dmi, tte, dly]
admitting: [a, dmi, tting]
adopt: [a, dopt]
adopted: [a, do, pted]
adopting: [a, do, pting]
adopts: [a, dopts]
advance: [a, dvan, ce]
advanced: [a, dvan, ced]
advances: [a, dvan, ces]
advancing: [a, dvan, cing]
advantage: [a, dvan, tage]
advantage's: [a, dvan, ta, ges]
advantages: [a, dvan, ta, ges]
advertise: [a, dver, tise]
advertised: [a, dver, ti, sed]
advertises: [a, dver, ti, ses]
advertising: [a, dver, ti, sing]
advice: [a, dvice]
advise: [a, dvise]
advised: [a, dvi, sed]
advises: [a, dvi, ses]
advising: [a, dvi, sing]
affair: [a, ffair]
affair's: [a, ffairs]
affairs: [a, ffairs]
affect: [a, ffect]
affect's: [a, ffects]
affected: [a, ffe, cted]
affecting: [a, ffe, cting]
affects: [a, ffects]
afford: [a, fford]
afraid: [a, fraid]
after: [af, ter]
afternoon: [af, ter, noon]
afterward: [af, te, rward]
afterwards: [af, te, rwards]
again: [a, gain]
against: [a, gainst]
age: [age]
age's: [a, ges]
agency: [a, gen, cy]
ages: [a, ges]
ago: [a, go]
agree: [a, gree]
agreed: [a, greed]
agreeing: [a, greeing]
agreement: [a, gree, ment]
agrees: [a, grees]
ahead: [a, head]
aid: [aid]
aim: [aim]
aimed: [ai, med]
aiming: [ai, ming]
aims: [aims]
air: [air]
alarm: [a, larm]
album: [al, bum]
algorithm: [al, go, rithm]
algorithm's: [al, go, rithms]
algorithms: [al, go, rithms]
alias: [a, lias]
alive: [a, live]
all: [all]
allow: [a, llow]
allowed: [a, llo, wed]
allowing: [a, llo, wing]
allows: [a, llows]
almost: [al, most]
alone: [a, lone]
along: [a, long]
already: [a, lrea, dy]
also: [al, so]
alter: [al, ter]
altered: [al, te, red]
altering: [al, te, ring]
alternate: [al, ter, nate]
alternative: [al, ter, na, tive]
alternative's: [al, ter, na, ti, ves]
alternatively: [al, ter, na, ti, ve, ly]
alternatives: [al, ter, na, ti, ves]
alters: [al, ters]
although: [al, though]
altogether: [al, to, ge, ther]
always: [a, lways]
am: [am]
ambiguous: [am, bi, guous]
among: [a, mong]
amongst: [a, mongst]
amount: [a, mount]
amount's: [a, mounts]
amounts: [a, mounts]
amuse: [a, muse]
amused: [a, mu, sed]
amuses: [a, mu, ses]
amusing: [a, mu, sing]
an: [an]
analog: [a, na, log]
analogue: [a, na, lo, gue]
analysis: [a, na, ly, sis]
ancient: [an, cient]
and: [and]
angle: [an, gle]
angry: [an, gry]
animal: [a, ni, mal]
announce: [a, nnoun, ce]
announcement: [a, nnoun, ce, ment]
annoy: [a, nnoy]
annoyed: [a, nno, yed]
annoying: [a, nno, ying]
annoys: [a, nnoys]
annual: [a, nnual]
anonymous: [a, no, ny, mous]
another: [a, no, ther]
answer: [an, swer]
answer's: [an, swers]
answered: [an, swe, red]
answering: [an, swe, ring]
answers: [an, swers]
any: [a, ny]
anybody: [a, ny, bo, dy]
anyone: [a, nyone]
anyplace: [a, ny, place]
anything: [a, ny, thing]
anyway: [a, ny, way]
anywhere: [a, ny, where]
apart: [a, part]
apologies: [a, po, lo, gies]
apologise: [a, po, lo, gise]
apologize: [a, po, lo, gize]
apology: [a, po, lo, gy]
apology's: [a, po, lo, gys]
apparent: [a, ppa, rent]
apparently: [a, ppa, ren, tly]
appeal: [a, ppeal]
appear: [a, ppear]
appearance: [a, ppea, ran, ce]
appeared: [a, ppea, red]
appearing: [a, ppea, ring]
appears: [a, ppears]
apple: [a, pple]
application: [a, ppli, ca, tion]
application's: [a, ppli, ca, tions]
applications: [a, ppli, ca, tions]
applied: [a, pplied]
applies: [a, pplies]
apply: [a, pply]
applying: [a, pplying]
appreciate: [a, ppre, ciate]
appreciated: [a, ppre, cia, ted]
appreciates: [a, ppre, cia, tes]
appreciating: [a, ppre, cia, ting]
approach: [a, pproach]
appropriate: [a, ppro, priate]
approval: [a, ppro, val]
approve: [a, pprove]
approved: [a, ppro, ved]
approves: [a, ppro, ves]
approving: [a, ppro, ving]
arbitrary: [ar, bi, tra, ry]
are: [are]
area: [a, rea]
area's: [a, reas]
areas: [a, reas]
aren't: [a, rent]
argue: [ar, gue]
argued: [ar, gued]
argues: [ar, gues]
arguing: [ar, guing]
argument: [ar, gu, ment]
argument's: [ar, gu, ments]
arguments: [ar, gu, ments]
arise: [a, rise]
arises: [a, ri, ses]
arithmetic: [a, ri, thme, tic]
arm: [arm]
army: [ar, my]
around: [a, round]
arrange: [a, rran, ge]
arranged: [a, rran, ged]
arrangement: [a, rran, ge, ment]
arrangement's: [a, rran, ge, ments]
arrangements: [a, rran, ge, ments]
arranges: [a, rran, ges]
arranging: [a, rran, ging]
arrive: [a, rrive]
arrived: [a, rri, ved]
arrives: [a, rri, ves]
arriving: [a, rri, ving]
art: [art]
article: [ar, ti, cle]
article's: [ar, ti, cles]
articles: [ar, ti, cles]
artificial: [ar, ti, fi, cial]
artist: [ar, tist]
as: [as]
aside: [a, side]
ask: [ask]
asked: [a, sked]
asking: [a, sking]
asks: [asks]
asleep: [a, sleep]
aspect: [a, spect]
aspect's: [a, spects]
aspects: [a, spects]
assembler: [a, ssem, bler]
assembly: [a, ssem, bly]
assistant: [a, ssi, stant]
associate: [a, sso, ciate]
associated: [a, sso, cia, ted]
associates: [a, sso, cia, tes]
associating: [a, sso, cia, ting]
association: [a, sso, cia, tion]
assume: [a, ssume]
assumed: [a, ssu, med]
assumes: [a, ssu, mes]
assuming: [a, ssu, ming]
assumption: [a, ssum, ption]
assure: [a, ssure]
assured: [a, ssu, red]
assures: [a, ssu, res]
assuring: [a, ssu, ring]
at: [at]
ate: [ate]
atmosphere: [a, tmo, sphere]
attach: [a, ttach]
attached: [a, tta, ched]
attaches: [a, tta, ches]
attaching: [a, tta, ching]
attack: [a, ttack]
attempt: [a, ttempt]
attempt's: [a, ttempts]
attempted: [a, ttem, pted]
attempting: [a, ttem, pting]
attempts: [a, ttempts]
attend: [a, ttend]
attended: [a, tten, ded]
attending: [a, tten, ding]
attends: [a, ttends]
attention: [a, tten, tion]
attitude: [a, tti, tude]
attract: [a, ttract]
attractive: [a, ttra, ctive]
audience: [au, dien, ce]
author: [au, thor]
author's: [au, thors]
authorities: [au, tho, ri, ties]
authority: [au, tho, ri, ty]
authority's: [au, tho, ri, tys]
authors: [au, thors]
automatic: [au, to, ma, tic]
automatically: [au, to, ma, ti, ca, lly]
automobile: [au, to, mo, bile]
autumn: [au, tumn]
autumn's: [au, tumns]
available: [a, vai, la, ble]
average: [a, ve, rage]
avoid: [a, void]
avoided: [a, voi, ded]
avoiding: [a, voi, ding]
avoids: [a, voids]
awake: [a, wake]
award: [a, ward]
aware: [a, ware]
away: [a, way]
awful: [aw, ful]
awkward: [aw, kward]
back: [back]
backed: [ba, cked]
background: [ba, ckground]
backing: [ba, cking]
backs: [backs]
backwards: [ba, ckwards]
bad: [bad]
badly: [ba, dly]
balance: [ba, lan, ce]
ball: [ball]
ban: [ban]
band: [band]
bank: [bank]
bar: [bar]
bar's: [bars]
bars: [bars]
base: [base]
based: [ba, sed]
bases: [ba, ses]
basic: [ba, sic]
basically: [ba, si, ca, lly]
basing: [ba, sing]
basis: [ba, sis]
battery: [ba, tte, ry]
be: [be]
bear: [bear]
bear's: [bears]
bearing: [bea, ring]
bears: [bears]
beautiful: [beau, ti, ful]
became: [be, came]
because: [be, cause]
become: [be, come]
becomes: [be, co, mes]
becoming: [be, co, ming]
bed: [bed]
been: [been]
before: [be, fore]
beforehand: [be, fo, re, hand]
began: [be, gan]
begin: [be, gin]
beginning: [be, gi, nning]
begins: [be, gins]
begun: [be, gun]
behalf: [be, half]
behave: [be, have]
behavior: [be, ha, vior]
behaviour: [be, ha, viour]
behind: [be, hind]
being: [being]
believe: [be, lieve]
believed: [be, lie, ved]
believes: [be, lie, ves]
believing: [be, lie, ving]
belong: [be, long]
belongs: [be, longs]
below: [be, low]
benefit: [be, ne, fit]
benefit's: [be, ne, fits]
benefits: [be, ne, fits]
besides: [be, si, des]
best: [best]
bet: [bet]
bets: [bets]
better: [be, tter]
betting: [be, tting]
between: [be, tween]
beyond: [be, yond]
bid: [bid]
bidding: [bi, dding]
bids: [bids]
big: [big]
bigger: [bi, gger]
biggest: [bi, ggest]
bill: [bill]
binary: [bi, na, ry]
bind: [bind]
binding: [bin, ding]
binds: [binds]
biology: [bio, lo, gy]
bit: [bit]
bit's: [bits]
bite: [bite]
bites: [bi, tes]
biting: [bi, ting]
bits: [bits]
bitten: [bi, tten]
bizarre: [bi, za, rre]
black: [black]
blame: [blame]
blank: [blank]
block: [block]
blow: [blow]
blue: [blue]
board: [board]
board's: [boards]
boards: [boards]
boat: [boat]
bodies: [bo, dies]
body: [bo, dy]
body's: [bo, dys]
book: [book]
book's: [books]
books: [books]
boot: [boot]
bore: [bore]
borne: [bor, ne]
borrow: [bo, rrow]
borrowed: [bo, rro, wed]
borrowing: [bo, rro, wing]
borrows: [bo, rrows]
both: [both]
bother: [bo, ther]
bothered: [bo, the, red]
bothering: [bo, the, ring]
bothers: [bo, thers]
bottle: [bo, ttle]
bottom: [bo, ttom]
bought: [bought]
bound: [bound]
box: [box]
box's: [boxs]
boxes: [bo, xes]
boy: [boy]
bracket: [bra, cket]
bracket's: [bra, ckets]
brackets: [bra, ckets]
branch: [branch]
branch's: [branchs]
branches: [bran, ches]
brand: [brand]
breach: [breach]
break: [break]
break's: [breaks]
breaking: [brea, king]
breaks: [breaks]
bridge: [bri, dge]
brief: [brief]
briefly: [brie, fly]
bright: [bright]
bring: [bring]
bringing: [brin, ging]
brings: [brings]
broadcast: [broa, dcast]
broadcasting: [broa, dca, sting]
broadcasts: [broa, dcasts]
broke: [broke]
broken: [bro, ken]
brother: [bro, ther]
brought: [brought]
brown: [brown]
bucket: [bu, cket]
budget: [bu, dget]
buffer: [bu, ffer]
bug: [bug]
bug's: [bugs]
bugs: [bugs]
build: [build]
building: [buil, ding]
building's: [buil, dings]
buildings: [buil, dings]
builds: [builds]
built: [built]
bulk: [bulk]
bulletin: [bu, lle, tin]
buried: [bu, ried]
buries: [bu, ries]
bury: [bu, ry]
burying: [bu, rying]
bus: [bus]
business: [bu, si, ness]
busy: [bu, sy]
but: [but]
button: [bu, tton]
buy: [buy]
buying: [bu, ying]
buys: [buys]
by: [by]
byte: [by, te]
byte's: [by, tes]
bytes: [by, tes]
calculate: [cal, cu, late]
calculation: [cal, cu, la, tion]
calculation's: [cal, cu, la, tions]
calculations: [cal, cu, la, tions]
call: [call]
call's: [calls]
called: [ca, lled]
calling: [ca, lling]
calls: [calls]
came: [came]
campaign: [cam, paign]
can: [can]
can't: [cant]
candidate: [can, di, date]
cannot: [ca, nnot]
capable: [ca, pa, ble]
capacity: [ca, pa, ci, ty]
capital: [ca, pi, tal]
captain: [ca, ptain]
car: [car]
card: [card]
card's: [cards]
cardboard: [car, dboard]
cards: [cards]
care: [care]
care's: [ca, res]
careful: [ca, re, ful]
carefully: [ca, re, fu, lly]
cares: [ca, res]
carried: [ca, rried]
carries: [ca, rries]
carry: [ca, rry]
carry's: [ca, rrys]
carrying: [ca, rrying]
case: [case]
case's: [ca, ses]
cases: [ca, ses]
cassette: [ca, sse, tte]
cat: [cat]
catalog: [ca, ta, log]
catalogue: [ca, ta, lo, gue]
catch: [catch]
catches: [ca, tches]
catching: [ca, tching]
categories: [ca, te, go, ries]
category: [ca, te, go, ry]
category's: [ca, te, go, rys]
caught: [caught]
cause: [cause]
cause's: [cau, ses]
caused: [cau, sed]
causes: [cau, ses]
causing: [cau, sing]
cease: [cease]
cell: [cell]
cent: [cent]
center: [cen, ter]
central: [cen, tral]
centre: [cen, tre]
century: [cen, tu, ry]
certain: [cer, tain]
certainly: [cer, tai, nly]
chain: [chain]
chair: [chair]
chairman: [chair, man]
chance: [chan, ce]
chance's: [chan, ces]
chances: [chan, ces]
change: [chan, ge]
change's: [chan, ges]
changed: [chan, ged]
changes: [chan, ges]
changing: [chan, ging]
channel: [cha, nnel]
channel's: [cha, nnels]
channels: [cha, nnels]
chaos: [chaos]
chapter: [cha, pter]
char: [char]
char's: [chars]
character: [cha, ra, cter]
character's: [cha, ra, cters]
characters: [cha, ra, cters]
charge: [char, ge]
charge's: [char, ges]
charged: [char, ged]
charges: [char, ges]
charging: [char, ging]
chars: [chars]
cheap: [cheap]
cheaper: [chea, per]
cheapest: [chea, pest]
check: [check]
check's: [checks]
checked: [che, cked]
checking: [che, cking]
checks: [checks]
chemical: [che, mi, cal]
cheque: [che, que]
cheque's: [che, ques]
chequed: [che, qued]
cheques: [che, ques]
chequing: [che, quing]
child: [child]
child's: [childs]
children: [chil, dren]
chip: [chip]
chip's: [chips]
chips: [chips]
choice: [choice]
choose: [choose]
chooses: [choo, ses]
choosing: [choo, sing]
chose: [chose]
chosen: [cho, sen]
church: [church]
circle: [cir, cle]
circuit: [cir, cuit]
circulation: [cir, cu, la, tion]
circumstance: [cir, cum, stan, ce]
circumstance's: [cir, cum, stan, ces]
circumstances: [cir, cum, stan, ces]
citizen: [ci, ti, zen]
city: [ci, ty]
claim: [claim]
claim's: [claims]
claimed: [clai, med]
claiming: [clai, ming]
claims: [claims]
clarify: [cla, ri, fy]
class: [class]
class's: [classs]
classes: [cla, sses]
clean: [clean]
clear: [clear]
cleared: [clea, red]
clearer: [clea, rer]
clearest: [clea, rest]
clearing: [clea, ring]
clearly: [clear, ly]
clears: [clears]
clever: [cle, ver]
clock: [clock]
close: [close]
closed: [clo, sed]
closely: [clo, se, ly]
closer: [clo, ser]
closes: [clo, ses]
closest: [clo, sest]
closing: [clo, sing]
club: [club]
clue: [clue]
code: [code]
code's: [co, des]
coded: [co, ded]
codes: [co, des]
coding: [co, ding]
coffee: [co, ffee]
cold: [cold]
collapse: [co, lla, pse]
collect: [co, llect]
collected: [co, lle, cted]
collecting: [co, lle, cting]
collection: [co, lle, ction]
collects: [co, llects]
college: [co, llege]
college's: [co, lle, ges]
colleges: [co, lle, ges]
color: [co, lor]
color's: [co, lors]
colors: [co, lors]
colour: [co, lour]
colour's: [co, lours]
colours: [co, lours]
column: [co, lumn]
combination: [com, bi, na, tion]
combination's: [com, bi, na, tions]
combinations: [com, bi, na, tions]
combine: [com, bine]
combined: [com, bi, ned]
combines: [com, bi, nes]
combining: [com, bi, ning]
come: [come]
comes: [co, mes]
coming: [co, ming]
command: [co, mmand]
command's: [co, mmands]
commands: [co, mmands]
comment: [co, mment]
comment's: [co, mments]
commented: [co, mmen, ted]
commenting: [co, mmen, ting]
comments: [co, mments]
commercial: [co, mmer, cial]
commission: [co, mmi, ssion]
commitment: [co, mmi, tment]
committee: [co, mmi, ttee]
common: [co, mmon]
commonly: [co, mmo, nly]
communicate: [co, mmu, ni, cate]
communication: [co, mmu, ni, ca, tion]
communication's: [co, mmu, ni, ca, tions]
communications: [co, mmu, ni, ca, tions]
community: [co, mmu, ni, ty]
company: [com, pa, ny]
comparable: [com, pa, ra, ble]
comparatively: [com, pa, ra, ti, ve, ly]
compare: [com, pare]
compared: [com, pa, red]
compares: [com, pa, res]
comparing: [com, pa, ring]
comparison: [com, pa, ri, son]
compatibility: [com, pa, ti, bi, li, ty]
compatible: [com, pa, ti, ble]
competition: [com, pe, ti, tion]
compiler: [com, pi, ler]
complain: [com, plain]
complained: [com, plai, ned]
complaining: [com, plai, ning]
complains: [com, plains]
complaint: [com, plaint]
complaint's: [com, plaints]
complaints: [com, plaints]
complete: [com, plete]
completed: [com, ple, ted]
completely: [com, ple, te, ly]
completes: [com, ple, tes]
completing: [com, ple, ting]
complex: [com, plex]
complexity: [com, ple, xi, ty]
complicate: [com, pli, cate]
complicated: [com, pli, ca, ted]
complicates: [com, pli, ca, tes]
complicating: [com, pli, ca, ting]
component: [com, po, nent]
component's: [com, po, nents]
components: [com, po, nents]
compose: [com, pose]
composed: [com, po, sed]
composes: [com, po, ses]
composing: [com, po, sing]
composition: [com, po, si, tion]
comprehensive: [com, pre, hen, sive]
compromise: [com, pro, mise]
compulsory: [com, pul, so, ry]
compute: [com, pute]
computed: [com, pu, ted]
computer: [com, pu, ter]
computer's: [com, pu, ters]
computers: [com, pu, ters]
computes: [com, pu, tes]
computing: [com, pu, ting]
concept: [con, cept]
concern: [con, cern]
concern's: [con, cerns]
concerned: [con, cer, ned]
concerning: [con, cer, ning]
concerns: [con, cerns]
conclusion: [con, clu, sion]
concrete: [con, crete]
condition: [con, di, tion]
condition's: [con, di, tions]
conditions: [con, di, tions]
conference: [con, fe, ren, ce]
confident: [con, fi, dent]
confirm: [con, firm]
confirmed: [con, fir, med]
confirming: [con, fir, ming]
confirms: [con, firms]
confuse: [con, fuse]
confused: [con, fu, sed]
confuses: [con, fu, ses]
confusing: [con, fu, sing]
confusion: [con, fu, sion]
connect: [co, nnect]
connected: [co, nne, cted]
connecting: [co, nne, cting]
connection: [co, nne, ction]
connection's: [co, nne, ctions]
connections: [co, nne, ctions]
connects: [co, nnects]
consequence: [con, se, quen, ce]
consequence's: [con, se, quen, ces]
consequences: [con, se, quen, ces]
consequently: [con, se, quen, tly]
consider: [con, si, der]
considerable: [con, si, de, ra, ble]
considerably: [con, si, de, ra, bly]
consideration: [con, si, de, ra, tion]
considered: [con, si, de, red]
considering: [con, si, de, ring]
considers: [con, si, ders]
consist: [con, sist]
consistency: [con, si, sten, cy]
consistent: [con, si, stent]
consists: [con, sists]
constant: [con, stant]
constraint: [con, straint]
constraint's: [con, straints]
constraints: [con, straints]
construct: [con, struct]
consumption: [con, sum, ption]
contact: [con, tact]
contain: [con, tain]
contained: [con, tai, ned]
containing: [con, tai, ning]
contains: [con, tains]
content: [con, tent]
content's: [con, tents]
contents: [con, tents]
context: [con, text]
continually: [con, ti, nua, lly]
continuation: [con, ti, nua, tion]
continue: [con, ti, nue]
continued: [con, ti, nued]
continues: [con, ti, nues]
continuing: [con, ti, nuing]
continuous: [con, ti, nuous]
continuously: [con, ti, nuou, sly]
contract: [con, tract]
contrary: [con, tra, ry]
contrast: [con, trast]
contribute: [con, tri, bute]
contribution: [con, tri, bu, tion]
contribution's: [con, tri, bu, tions]
contributions: [con, tri, bu, tions]
control: [con, trol]
control's: [con, trols]
controlled: [con, tro, lled]
controlling: [con, tro, lling]
controls: [con, trols]
convenient: [con, ve, nient]
convention: [con, ven, tion]
convention's: [con, ven, tions]
conventional: [con, ven, tio, nal]
conventions: [con, ven, tions]
conversation: [con, ver, sa, tion]
convert: [con, vert]
convince: [con, vin, ce]
convinced: [con, vin, ced]
convinces: [con, vin, ces]
convincing: [con, vin, cing]
cope: [cope]
copied: [co, pied]
copies: [co, pies]
copy: [co, py]
copy's: [co, pys]
copying: [co, pying]
core: [core]
corner: [cor, ner]
corner's: [cor, ners]
corners: [cor, ners]
correct: [co, rrect]
corrected: [co, rre, cted]
correcting: [co, rre, cting]
correction: [co, rre, ction]
correctly: [co, rre, ctly]
corrects: [co, rrects]
corrupt: [co, rrupt]
corrupted: [co, rru, pted]
corrupting: [co, rru, pting]
corrupts: [co, rrupts]
cost: [cost]
cost's: [costs]
costing: [co, sting]
costs: [costs]
could: [could]
couldn't: [couldnt]
council: [coun, cil]
count: [count]
count's: [counts]
counted: [coun, ted]
counter: [coun, ter]
counting: [coun, ting]
country: [coun, try]
counts: [counts]
county: [coun, ty]
couple: [cou, ple]
course: [cour, se]
course's: [cour, ses]
courses: [cour, ses]
court: [court]
cover: [co, ver]
cover's: [co, vers]
covered: [co, ve, red]
covering: [co, ve, ring]
covers: [co, vers]
crash: [crash]
crash's: [crashs]
crashed: [cra, shed]
crashes: [cra, shes]
crashing: [cra, shing]
crazy: [cra, zy]
create: [create]
created: [crea, ted]
creates: [crea, tes]
creating: [crea, ting]
creation: [crea, tion]
creature: [crea, ture]
credit: [cre, dit]
crisis: [cri, sis]
crisp: [crisp]
crisp's: [crisps]
crisps: [crisps]
critical: [cri, ti, cal]
criticism: [cri, ti, cism]
cross: [cross]
cry: [cry]
cs: []
culture: [cul, ture]
cum: [cum]
cumming: [cu, mming]
cums: [cums]
cup: [cup]
cure: [cure]
curious: [cu, rious]
current: [cu, rrent]
currently: [cu, rren, tly]
cursor: [cur, sor]
customer: [cu, sto, mer]
cut: [cut]
cuts: [cuts]
cutting: [cu, tting]
cycle: [cy, cle]
cycle's: [cy, cles]
cycles: [cy, cles]
daily: [dai, ly]
damage: [da, mage]
damaged: [da, ma, ged]
damages: [da, ma, ges]
damaging: [da, ma, ging]
danger: [dan, ger]
dangerous: [dan, ge, rous]
dare: [dare]
dark: [dark]
data: [da, ta]
database: [da, ta, base]
date: [date]
date's: [da, tes]
dated: [da, ted]
dates: [da, tes]
dating: [da, ting]
datum: [da, tum]
datum's: [da, tums]
day: [day]
day's: [days]
days: [days]
dead: [dead]
dead's: [deads]
deal: [deal]
deal's: [deals]
dealing: [dea, ling]
deals: [deals]
dealt: [dealt]
dear: [dear]
death: [death]
debate: [de, bate]
decade: [de, cade]
decent: [de, cent]
decide: [de, cide]
decided: [de, ci, ded]
decides: [de, ci, des]
deciding: [de, ci, ding]
decision: [de, ci, sion]
decision's: [de, ci, sions]
decisions: [de, ci, sions]
declare: [de, clare]
declared: [de, cla, red]
declares: [de, cla, res]
declaring: [de, cla, ring]
decrease: [de, crease]
dedicate: [de, di, cate]
dedicated: [de, di, ca, ted]
dedicates: [de, di, ca, tes]
dedicating: [de, di, ca, ting]
deduce: [de, duce]
deem: [deem]
deemed: [dee, med]
deeming: [dee, ming]
deems: [deems]
deep: [deep]
deeply: [dee, ply]
default: [de, fault]
defence: [de, fen, ce]
defense: [de, fen, se]
define: [de, fine]
defined: [de, fi, ned]
defines: [de, fi, nes]
defining: [de, fi, ning]
definite: [de, fi, nite]
definitely: [de, fi, ni, te, ly]
definition: [de, fi, ni, tion]
definition's: [de, fi, ni, tions]
definitions: [de, fi, ni, tions]
definitive: [de, fi, ni, tive]
degree: [de, gree]
degree's: [de, grees]
degrees: [de, grees]
delay: [de, lay]
delete: [de, lete]
deleted: [de, le, ted]
deletes: [de, le, tes]
deleting: [de, le, ting]
deliberate: [de, li, be, rate]
deliberately: [de, li, be, ra, te, ly]
deliver: [de, li, ver]
delivered: [de, li, ve, red]
delivering: [de, li, ve, ring]
delivers: [de, li, vers]
delivery: [de, li, ve, ry]
demand: [de, mand]
demand's: [de, mands]
demands: [de, mands]
democratic: [de, mo, cra, tic]
demonstrate: [de, mon, strate]
demonstration: [de, mon, stra, tion]
department: [de, par, tment]
depend: [de, pend]
depended: [de, pen, ded]
depending: [de, pen, ding]
depends: [de, pends]
depth: [depth]
derive: [de, rive]
derived: [de, ri, ved]
derives: [de, ri, ves]
deriving: [de, ri, ving]
describe: [de, scribe]
described: [de, scri, bed]
describes: [de, scri, bes]
describing: [de, scri, bing]
description: [de, scri, ption]
description's: [de, scri, ptions]
descriptions: [de, scri, ptions]
design: [de, sign]
designed: [de, si, gned]
designing: [de, si, gning]
designs: [de, signs]
desirable: [de, si, ra, ble]
desire: [de, sire]
desired: [de, si, red]
desires: [de, si, res]
desiring: [de, si, ring]
desk: [desk]
desperate: [de, spe, rate]
despite: [de, spite]
destroy: [de, stroy]
destroyed: [de, stro, yed]
destroying: [de, stro, ying]
destroys: [de, stroys]
detail: [de, tail]
detail's: [de, tails]
detailed: [de, tai, led]
detailing: [de, tai, ling]
details: [de, tails]
detect: [de, tect]
detected: [de, te, cted]
detecting: [de, te, cting]
detects: [de, tects]
determine: [de, ter, mine]
determined: [de, ter, mi, ned]
determines: [de, ter, mi, nes]
determining: [de, ter, mi, ning]
develop: [de, ve, lop]
developed: [de, ve, lo, ped]
developing: [de, ve, lo, ping]
development: [de, ve, lo, pment]
develops: [de, ve, lops]
device: [de, vice]
device's: [de, vi, ces]
devices: [de, vi, ces]
devote: [de, vote]
devoted: [de, vo, ted]
devotes: [de, vo, tes]
devoting: [de, vo, ting]
dictionary: [di, ctio, na, ry]
did: [did]
didn't: [didnt]
die: [die]
died: [died]
dies: [dies]
differ: [di, ffer]
difference: [di, ffe, ren, ce]
difference's: [di, ffe, ren, ces]
differences: [di, ffe, ren, ces]
different: [di, ffe, rent]
differently: [di, ffe, ren, tly]
difficult: [di, ffi, cult]
difficulties: [di, ffi, cul, ties]
difficulty: [di, ffi, cul, ty]
difficulty's: [di, ffi, cul, tys]
digit: [di, git]
digit's: [di, gits]
digital: [di, gi, tal]
digits: [di, gits]
dinner: [di, nner]
direct: [di, rect]
directed: [di, re, cted]
directing: [di, re, cting]
direction: [di, re, ction]
direction's: [di, re, ctions]
directions: [di, re, ctions]
directly: [di, re, ctly]
director: [di, re, ctor]
directory: [di, re, cto, ry]
directs: [di, rects]
dirty: [dir, ty]
disadvantage: [di, sa, dvan, tage]
disagree: [di, sa, gree]
disappear: [di, sa, ppear]
disappeared: [di, sa, ppea, red]
disappearing: [di, sa, ppea, ring]
disappears: [di, sa, ppears]
disaster: [di, sa, ster]
disc: [disc]
disc's: [discs]
discipline: [di, sci, pline]
discount: [di, scount]
discourage: [di, scou, rage]
discouraged: [di, scou, ra, ged]
discourages: [di, scou, ra, ges]
discouraging: [di, scou, ra, ging]
discover: [di, sco, ver]
discovered: [di, sco, ve, red]
discovering: [di, sco, ve, ring]
discovers: [di, sco, vers]
discs: [discs]
discuss: [di, scuss]
discussed: [di, scu, ssed]
discusses: [di, scu, sses]
discussing: [di, scu, ssing]
discussion: [di, scu, ssion]
discussion's: [di, scu, ssions]
discussions: [di, scu, ssions]
disk: [disk]
dislike: [di, slike]
display: [di, splay]
displayed: [di, spla, yed]
displaying: [di, spla, ying]
displays: [di, splays]
distance: [di, stan, ce]
distant: [di, stant]
distinct: [di, stinct]
distinction: [di, stin, ction]
distinctly: [di, stin, ctly]
distinguish: [di, stin, guish]
distribute: [di, stri, bute]
distributed: [di, stri, bu, ted]
distributes: [di, stri, bu, tes]
distributing: [di, stri, bu, ting]
distribution: [di, stri, bu, tion]
district: [di, strict]
disturb: [di, sturb]
disturbed: [di, stur, bed]
disturbing: [di, stur, bing]
disturbs: [di, sturbs]
ditto: [di, tto]
divide: [di, vide]
divided: [di, vi, ded]
divides: [di, vi, des]
dividing: [di, vi, ding]
division: [di, vi, sion]
do: [do]
document: [do, cu, ment]
document's: [do, cu, ments]
documentation: [do, cu, men, ta, tion]
documented: [do, cu, men, ted]
documenting: [do, cu, men, ting]
documents: [do, cu, ments]
doe: [doe]
doe's: [does]
does: [does]
doesn't: [doesnt]
dog: [dog]
doing: [doing]
dollar: [do, llar]
domain: [do, main]
don't: [dont]
done: [done]
door: [door]
door's: [doors]
doors: [doors]
double: [dou, ble]
doubt: [doubt]
doubtful: [dou, btful]
down: [down]
dozen: [do, zen]
dozen's: [do, zens]
dozens: [do, zens]
drastic: [dra, stic]
draw: [draw]
draw's: [draws]
drawing: [dra, wing]
drawn: [drawn]
draws: [draws]
dream: [dream]
drew: [drew]
drink: [drink]
drive: [drive]
drive's: [dri, ves]
driven: [dri, ven]
driver: [dri, ver]
driver's: [dri, vers]
drivers: [dri, vers]
drives: [dri, ves]
driving: [dri, ving]
drop: [drop]
dropped: [dro, pped]
dropping: [dro, pping]
drops: [drops]
drove: [drove]
dry: [dry]
dubious: [du, bious]
due: [due]
dumb: [dumb]
dump: [dump]
during: [du, ring]
duty: [du, ty]
dying: [dying]
each: [each]
earlier: [ear, lier]
earliest: [ear, liest]
early: [ear, ly]
earth: [earth]
ease: [ease]
easier: [ea, sier]
easiest: [ea, siest]
easily: [ea, si, ly]
east: [east]
easy: [ea, sy]
eat: [eat]
eaten: [ea, ten]
eating: [ea, ting]
eats: [eats]
economic: [e, co, no, mic]
economy: [e, co, no, my]
edge: [e, dge]
edit: [e, dit]
edited: [e, di, ted]
editing: [e, di, ting]
edition: [e, di, tion]
editor: [e, di, tor]
editor's: [e, di, tors]
editors: [e, di, tors]
edits: [e, dits]
education: [e, du, ca, tion]
educational: [e, du, ca, tio, nal]
effect: [e, ffect]
effect's: [e, ffects]
effective: [e, ffe, ctive]
effectively: [e, ffe, cti, ve, ly]
effects: [e, ffects]
efficient: [e, ffi, cient]
effort: [e, ffort]
effort's: [e, fforts]
efforts: [e, fforts]
eight: [eight]
either: [ei, ther]
elect: [e, lect]
elected: [e, le, cted]
electing: [e, le, cting]
election: [e, le, ction]
electric: [e, le, ctric]
electronic: [e, le, ctro, nic]
electronics: [e, le, ctro, nics]
elects: [e, lects]
element: [e, le, ment]
element's: [e, le, ments]
elements: [e, le, ments]
elevator: [e, le, va, tor]
else: [el, se]
elsewhere: [el, se, where]
embarrass: [em, ba, rrass]
embarrassed: [em, ba, rra, ssed]
embarrasses: [em, ba, rra, sses]
embarrassing: [em, ba, rra, ssing]
emergency: [e, mer, gen, cy]
emphasis: [em, pha, sis]
employee: [em, plo, yee]
empty: [em, pty]
enable: [e, na, ble]
enables: [e, na, bles]
encounter: [en, coun, ter]
encountered: [en, coun, te, red]
encountering: [en, coun, te, ring]
encounters: [en, coun, ters]
encourage: [en, cou, rage]
encouraged: [en, cou, ra, ged]
encourages: [en, cou, ra, ges]
encouraging: [en, cou, ra, ging]
end: [end]
end's: [ends]
ended: [en, ded]
ending: [en, ding]
ends: [ends]
enemy: [e, ne, my]
engineer: [en, gi, neer]
engineer's: [en, gi, neers]
engineered: [en, gi, nee, red]
engineering: [en, gi, nee, ring]
engineers: [en, gi, neers]
enjoy: [en, joy]
enormous: [e, nor, mous]
enough: [e, nough]
ensure: [en, sure]
ensured: [en, su, red]
ensures: [en, su, res]
ensuring: [en, su, ring]
enter: [en, ter]
entered: [en, te, red]
entering: [en, te, ring]
enters: [en, ters]
entire: [en, tire]
entirely: [en, ti, re, ly]
entitle: [en, ti, tle]
entitled: [en, ti, tled]
entitles: [en, ti, tles]
entitling: [en, ti, tling]
entity: [en, ti, ty]
entrance: [en, tran, ce]
entries: [en, tries]
entry: [en, try]
entry's: [en, trys]
environment: [en, vi, ro, nment]
equal: [e, qual]
equally: [e, qua, lly]
equipment: [e, qui, pment]
equivalent: [e, qui, va, lent]
eraser: [e, ra, ser]
err: [err]
error: [e, rror]
error's: [e, rrors]
errors: [e, rrors]
escape: [e, scape]
especially: [e, spe, cia, lly]
essential: [e, ssen, tial]
essentially: [e, ssen, tia, lly]
establish: [e, sta, blish]
established: [e, sta, bli, shed]
establishes: [e, sta, bli, shes]
establishing: [e, sta, bli, shing]
establishment: [e, sta, bli, shment]
estimate: [e, sti, mate]
even: [e, ven]
evened: [e, ve, ned]
evening: [e, ve, ning]
evening's: [e, ve, nings]
evenings: [e, ve, nings]
evens: [e, vens]
event: [e, vent]
event's: [e, vents]
events: [e, vents]
eventually: [e, ven, tua, lly]
ever: [e, ver]
every: [e, ve, ry]
everybody: [e, ve, ry, bo, dy]
everyone: [e, ve, ryone]
everything: [e, ve, ry, thing]
everywhere: [e, ve, ry, where]
evidence: [e, vi, den, ce]
exact: [e, xact]
exactly: [e, xa, ctly]
examine: [e, xa, mine]
examined: [e, xa, mi, ned]
examines: [e, xa, mi, nes]
examining: [e, xa, mi, ning]
example: [e, xam, ple]
example's: [e, xam, ples]
examples: [e, xam, ples]
excellent: [ex, ce, llent]
except: [ex, cept]
exception: [ex, ce, ption]
exception's: [ex, ce, ptions]
exceptions: [ex, ce, ptions]
excess: [ex, cess]
excessive: [ex, ce, ssive]
exchange: [ex, chan, ge]
exclude: [ex, clude]
excluded: [ex, clu, ded]
excludes: [ex, clu, des]
excluding: [ex, clu, ding]
exclusive: [ex, clu, sive]
excuse: [ex, cuse]
execute: [e, xe, cute]
executed: [e, xe, cu, ted]
executes: [e, xe, cu, tes]
executing: [e, xe, cu, ting]
exercise: [e, xer, cise]
exist: [e, xist]
existed: [e, xi, sted]
existence: [e, xi, sten, ce]
existing: [e, xi, sting]
exists: [e, xists]
expand: [ex, pand]
expanded: [ex, pan, ded]
expanding: [ex, pan, ding]
expands: [ex, pands]
expansion: [ex, pan, sion]
expect: [ex, pect]
expected: [ex, pe, cted]
expecting: [ex, pe, cting]
expects: [ex, pects]
expense: [ex, pen, se]
expensive: [ex, pen, sive]
experience: [ex, pe, rien, ce]
experience's: [ex, pe, rien, ces]
experienced: [ex, pe, rien, ced]
experiences: [ex, pe, rien, ces]
experiencing: [ex, pe, rien, cing]
experiment: [ex, pe, ri, ment]
experiment's: [ex, pe, ri, ments]
experimental: [ex, pe, ri, men, tal]
experiments: [ex, pe, ri, ments]
expert: [ex, pert]
expert's: [ex, perts]
experts: [ex, perts]
explain: [ex, plain]
explained: [ex, plai, ned]
explaining: [ex, plai, ning]
explains: [ex, plains]
explanation: [ex, pla, na, tion]
explicit: [ex, pli, cit]
express: [ex, press]
expressed: [ex, pre, ssed]
expresses: [ex, pre, sses]
expressing: [ex, pre, ssing]
expression: [ex, pre, ssion]
extend: [ex, tend]
extended: [ex, ten, ded]
extending: [ex, ten, ding]
extends: [ex, tends]
extension: [ex, ten, sion]
extensive: [ex, ten, sive]
extent: [ex, tent]
external: [ex, ter, nal]
extra: [ex, tra]
extract: [ex, tract]
extreme: [ex, treme]
extremely: [ex, tre, me, ly]
eye: [eye]
eye's: [e, yes]
eyes: [e, yes]
face: [face]
facilities: [fa, ci, li, ties]
facility: [fa, ci, li, ty]
facility's: [fa, ci, li, tys]
fact: [fact]
fact's: [facts]
factor: [fa, ctor]
factor's: [fa, ctors]
factors: [fa, ctors]
facts: [facts]
fail: [fail]
fail's: [fails]
failed: [fai, led]
failing: [fai, ling]
fails: [fails]
failure: [fai, lure]
fair: [fair]
fairly: [fair, ly]
faith: [faith]
fall: [fall]
fall's: [falls]
fallen: [fa, llen]
falling: [fa, lling]
falls: [falls]
false: [fal, se]
familiar: [fa, mi, liar]
family: [fa, mi, ly]
famous: [fa, mous]
fan: [fan]
fancy: [fan, cy]
far: [far]
farm: [farm]
farther: [far, ther]
farthest: [far, thest]
fashion: [fa, shion]
fast: [fast]
faster: [fa, ster]
fastest: [fa, stest]
fatal: [fa, tal]
fate: [fate]
father: [fa, ther]
fault: [fault]
fault's: [faults]
faults: [faults]
favor: [fa, vor]
favorite: [fa, vo, rite]
favour: [fa, vour]
favourite: [fa, vou, rite]
fear: [fear]
feasible: [fea, si, ble]
feature: [fea, ture]
feature's: [fea, tu, res]
features: [fea, tu, res]
fed: [fed]
federal: [fe, de, ral]
feed: [feed]
feedback: [fee, dback]
feeding: [fee, ding]
feeds: [feeds]
feel: [feel]
feel's: [feels]
feeling: [fee, ling]
feels: [feels]
feet: [feet]
fell: [fell]
felt: [felt]
few: [few]
fewer: [fe, wer]
fewest: [fe, west]
field: [field]
field's: [fields]
fields: [fields]
fight: [fight]
figure: [fi, gure]
figure's: [fi, gu, res]
figures: [fi, gu, res]
file: [file]
file's: [fi, les]
filed: [fi, led]
files: [fi, les]
filing: [fi, ling]
fill: [fill]
filled: [fi, lled]
filling: [fi, lling]
fills: [fills]
film: [film]
final: [fi, nal]
finally: [fi, na, lly]
financial: [fi, nan, cial]
find: [find]
find's: [finds]
finding: [fin, ding]
finds: [finds]
fine: [fine]
finger: [fin, ger]
finger's: [fin, gers]
fingers: [fin, gers]
finish: [fi, nish]
finished: [fi, ni, shed]
finishes: [fi, ni, shes]
finishing: [fi, ni, shing]
finite: [fi, nite]
fire: [fire]
firm: [firm]
firmly: [fir, mly]
first: [first]
firstly: [fir, stly]
fiscal: [fi, scal]
fish: [fish]
fish's: [fishs]
fishes: [fi, shes]
fit: [fit]
fit's: [fits]
fits: [fits]
fitted: [fi, tted]
fitting: [fi, tting]
five: [five]
fix: [fix]
fixed: [fi, xed]
fixes: [fi, xes]
fixing: [fi, xing]
flag: [flag]
flash: [flash]
flashed: [fla, shed]
flashes: [fla, shes]
flashing: [fla, shing]
flat: [flat]
flavor: [fla, vor]
flavour: [fla, vour]
flew: [flew]
flexible: [fle, xi, ble]
flied: [flied]
flies: [flies]
flight: [flight]
float: [float]
floated: [floa, ted]
floating: [floa, ting]
floats: [floats]
floor: [floor]
flow: [flow]
flown: [flown]
fly: [fly]
fly's: [flys]
flying: [flying]
folk: [folk]
folk's: [folks]
folks: [folks]
follow: [fo, llow]
followed: [fo, llo, wed]
following: [fo, llo, wing]
follows: [fo, llows]
food: [food]
foot: [foot]
foot's: [foots]
for: [for]
force: [for, ce]
force's: [for, ces]
forced: [for, ced]
forces: [for, ces]
forcing: [for, cing]
foreign: [fo, reign]
forever: [fo, re, ver]
forget: [for, get]
forgets: [for, gets]
forgetting: [for, ge, tting]
forgot: [for, got]
forgotten: [for, go, tten]
form: [form]
form's: [forms]
formal: [for, mal]
format: [for, mat]
formed: [for, med]
former: [for, mer]
forming: [for, ming]
forms: [forms]
forth: [forth]
forthcoming: [forth, co, ming]
fortunately: [for, tu, na, te, ly]
fortune: [for, tune]
forward: [fo, rward]
found: [found]
four: [four]
fourth: [fourth]
fraction: [fra, ction]
frame: [frame]
free: [free]
freedom: [free, dom]
freely: [free, ly]
french: [french]
frequent: [fre, quent]
frequently: [fre, quen, tly]
fresh: [fresh]
friend: [friend]
friend's: [friends]
friendly: [frien, dly]
friends: [friends]
fries: [fries]
from: [from]
front: [front]
fry: [fry]
fry's: [frys]
full: [full]
fully: [fu, lly]
fun: [fun]
function: [fun, ction]
function's: [fun, ctions]
functions: [fun, ctions]
fund: [fund]
fund's: [funds]
fundamental: [fun, da, men, tal]
fundamentally: [fun, da, men, ta, lly]
funds: [funds]
funny: [fu, nny]
further: [fur, ther]
furthest: [fur, thest]
future: [fu, ture]
gain: [gain]
gained: [gai, ned]
gaining: [gai, ning]
gains: [gains]
game: [game]
game's: [ga, mes]
games: [ga, mes]
gap: [gap]
garbage: [gar, bage]
garden: [gar, den]
gas: [gas]
gasoline: [ga, so, line]
gather: [ga, ther]
gave: [gave]
general: [ge, ne, ral]
generally: [ge, ne, ra, lly]
generate: [ge, ne, rate]
generated: [ge, ne, ra, ted]
generates: [ge, ne, ra, tes]
generating: [ge, ne, ra, ting]
generation: [ge, ne, ra, tion]
genuine: [ge, nuine]
get: [get]
gets: [gets]
getting: [ge, tting]
girl: [girl]
give: [give]
given: [gi, ven]
gives: [gi, ves]
giving: [gi, ving]
glad: [glad]
glass: [glass]
global: [glo, bal]
go: [go]
go's: [gos]
goes: [goes]
going: [going]
gone: [gone]
good: [good]
goods: [goods]
got: [got]
gotten: [go, tten]
government: [go, ver, nment]
governor: [go, ver, nor]
gradually: [gra, dua, lly]
graduate: [gra, duate]
grand: [grand]
grand's: [grands]
grands: [grands]
grant: [grant]
granted: [gran, ted]
granting: [gran, ting]
grants: [grants]
graph: [graph]
graphic: [gra, phic]
graphic's: [gra, phics]
graphics: [gra, phics]
grateful: [gra, te, ful]
grave: [grave]
gray: [gray]
great: [great]
greater: [grea, ter]
greatest: [grea, test]
greatly: [grea, tly]
green: [green]
grew: [grew]
grey: [grey]
grind: [grind]
grinding: [grin, ding]
grinds: [grinds]
gross: [gross]
gross's: [grosss]
grosses: [gro, sses]
ground: [ground]
ground's: [grounds]
grounds: [grounds]
group: [group]
group's: [groups]
groups: [groups]
grow: [grow]
growing: [gro, wing]
grown: [grown]
grows: [grows]
growth: [growth]
guarantee: [gua, ran, tee]
guaranteed: [gua, ran, teed]
guaranteeing: [gua, ran, teeing]
guarantees: [gua, ran, tees]
guard: [guard]
guess: [guess]
guessed: [gue, ssed]
guesses: [gue, sses]
guessing: [gue, ssing]
guide: [guide]
gun: [gun]
guy: [guy]
habit: [ha, bit]
habit's: [ha, bits]
habits: [ha, bits]
hack: [hack]
had: [had]
hair: [hair]
half: [half]
hall: [hall]
hand: [hand]
hand's: [hands]
handed: [han, ded]
handing: [han, ding]
handle: [han, dle]
handled: [han, dled]
handles: [han, dles]
handling: [han, dling]
hands: [hands]
handy: [han, dy]
hang: [hang]
hanged: [han, ged]
hanging: [han, ging]
hangs: [hangs]
happen: [ha, ppen]
happened: [ha, ppe, ned]
happening: [ha, ppe, ning]
happens: [ha, ppens]
happily: [ha, ppi, ly]
happy: [ha, ppy]
hard: [hard]
harder: [har, der]
hardest: [har, dest]
hardly: [har, dly]
hardware: [har, dware]
harm: [harm]
harmful: [harm, ful]
harmless: [har, mless]
has: [has]
hat: [hat]
hate: [hate]
have: [have]
haven't: [ha, vent]
having: [ha, ving]
he: [he]
he's: [hes]
head: [head]
head's: [heads]
headed: [hea, ded]
header: [hea, der]
heading: [hea, ding]
heads: [heads]
health: [health]
healthy: [heal, thy]
hear: [hear]
heard: [heard]
hearing: [hea, ring]
hears: [hears]
heart: [heart]
heat: [heat]
heavily: [hea, vi, ly]
heavy: [hea, vy]
held: [held]
hell: [hell]
hello: [he, llo]
help: [help]
helped: [hel, ped]
helpful: [hel, pful]
helping: [hel, ping]
helps: [helps]
hence: [hen, ce]
her: [her]
here: [here]
hereby: [he, re, by]
herself: [her, self]
hes: [hes]
hid: [hid]
hidden: [hi, dden]
hide: [hide]
hides: [hi, des]
hiding: [hi, ding]
high: [high]
higher: [hi, gher]
highest: [hi, ghest]
highly: [hi, ghly]
hill: [hill]
him: [him]
himself: [him, self]
hint: [hint]
hint's: [hints]
hints: [hints]
his: [his]
historical: [hi, sto, ri, cal]
history: [hi, sto, ry]
hit: [hit]
hit's: [hits]
hits: [hits]
hitting: [hi, tting]
hold: [hold]
hold's: [holds]
holding: [hol, ding]
holds: [holds]
hole: [hole]
hole's: [ho, les]
holes: [ho, les]
holiday: [ho, li, day]
holiday's: [ho, li, days]
holidays: [ho, li, days]
home: [home]
honest: [ho, nest]
hope: [hope]
hoped: [ho, ped]
hopefully: [ho, pe, fu, lly]
hopes: [ho, pes]
hoping: [ho, ping]
horrible: [ho, rri, ble]
horse: [hor, se]
horse's: [hor, ses]
horses: [hor, ses]
hospital: [ho, spi, tal]
host: [host]
hot: [hot]
hotel: [ho, tel]
hour: [hour]
hour's: [hours]
hours: [hours]
house: [house]
how: [how]
however: [ho, we, ver]
huge: [huge]
human: [hu, man]
hundred: [hun, dred]
hundred's: [hun, dreds]
hundreds: [hun, dreds]
hung: [hung]
hunt: [hunt]
hurry: [hu, rry]
husband: [hus, band]
ice: [ice]
idea: [i, dea]
idea's: [i, deas]
ideal: [i, deal]
ideas: [i, deas]
identical: [i, den, ti, cal]
identify: [i, den, ti, fy]
identity: [i, den, ti, ty]
if: [if]
ignore: [i, gnore]
ignored: [i, gno, red]
ignores: [i, gno, res]
ignoring: [i, gno, ring]
ill: [ill]
illegal: [i, lle, gal]
image: [i, mage]
image's: [i, ma, ges]
images: [i, ma, ges]
imagination: [i, ma, gi, na, tion]
imagine: [i, ma, gine]
immediate: [i, mme, diate]
immediately: [i, mme, dia, te, ly]
impact: [im, pact]
implement: [im, ple, ment]
implemented: [im, ple, men, ted]
implementing: [im, ple, men, ting]
implements: [im, ple, ments]
implication: [im, pli, ca, tion]
implication's: [im, pli, ca, tions]
implications: [im, pli, ca, tions]
implied: [im, plied]
implies: [im, plies]
imply: [im, ply]
implying: [im, plying]
importance: [im, por, tan, ce]
important: [im, por, tant]
importantly: [im, por, tan, tly]
impose: [im, pose]
imposed: [im, po, sed]
imposes: [im, po, ses]
imposing: [im, po, sing]
impossible: [im, po, ssi, ble]
impression: [im, pre, ssion]
improve: [im, prove]
improved: [im, pro, ved]
improvement: [im, pro, ve, ment]
improvement's: [im, pro, ve, ments]
improvements: [im, pro, ve, ments]
improves: [im, pro, ves]
improving: [im, pro, ving]
in: [in]
inability: [i, na, bi, li, ty]
inadequate: [i, na, de, quate]
inch: [inch]
inch's: [inchs]
inches: [in, ches]
incident: [in, ci, dent]
incidentally: [in, ci, den, ta, lly]
incline: [in, cline]
inclined: [in, cli, ned]
inclines: [in, cli, nes]
inclining: [in, cli, ning]
include: [in, clude]
included: [in, clu, ded]
includes: [in, clu, des]
including: [in, clu, ding]
income: [in, come]
incompatible: [in, com, pa, ti, ble]
incomplete: [in, com, plete]
inconsistent: [in, con, si, stent]
inconvenience: [in, con, ve, nien, ce]
incorrect: [in, co, rrect]
increase: [in, crease]
increase's: [in, crea, ses]
increased: [in, crea, sed]
increases: [in, crea, ses]
increasing: [in, crea, sing]
indeed: [in, deed]
independent: [in, de, pen, dent]
independently: [in, de, pen, den, tly]
index: [in, dex]
indicate: [in, di, cate]
indicates: [in, di, ca, tes]
indication: [in, di, ca, tion]
individual: [in, di, vi, dual]
individual's: [in, di, vi, duals]
individually: [in, di, vi, dua, lly]
individuals: [in, di, vi, duals]
industrial: [in, du, strial]
industry: [in, du, stry]
inevitably: [i, ne, vi, ta, bly]
inferior: [in, fe, rior]
infinite: [in, fi, nite]
influence: [in, fluen, ce]
info: [in, fo]
inform: [in, form]
information: [in, for, ma, tion]
informed: [in, for, med]
informing: [in, for, ming]
informs: [in, forms]
initial: [i, ni, tial]
initial's: [i, ni, tials]
initially: [i, ni, tia, lly]
initials: [i, ni, tials]
inner: [i, nner]
innocent: [i, nno, cent]
input: [in, put]
inputs: [in, puts]
inputted: [in, pu, tted]
inputting: [in, pu, tting]
insert: [in, sert]
inserted: [in, ser, ted]
inserting: [in, ser, ting]
inserts: [in, serts]
inside: [in, side]
insist: [in, sist]
insisted: [in, si, sted]
insisting: [in, si, sting]
insists: [in, sists]
install: [in, stall]
installed: [in, sta, lled]
installing: [in, sta, lling]
installs: [in, stalls]
instance: [in, stan, ce]
instant: [in, stant]
instantly: [in, stan, tly]
instead: [in, stead]
institution: [in, sti, tu, tion]
institution's: [in, sti, tu, tions]
institutions: [in, sti, tu, tions]
instruction: [in, stru, ction]
instruction's: [in, stru, ctions]
instructions: [in, stru, ctions]
insurance: [in, su, ran, ce]
integer: [in, te, ger]
integer's: [in, te, gers]
integers: [in, te, gers]
integral: [in, te, gral]
intelligence: [in, te, lli, gen, ce]
intelligent: [in, te, lli, gent]
intend: [in, tend]
intended: [in, ten, ded]
intending: [in, ten, ding]
intends: [in, tends]
intention: [in, ten, tion]
interact: [in, te, ract]
interest: [in, te, rest]
interest's: [in, te, rests]
interested: [in, te, re, sted]
interesting: [in, te, re, sting]
interests: [in, te, rests]
interface: [in, ter, face]
internal: [in, ter, nal]
international: [in, ter, na, tio, nal]
interpret: [in, ter, pret]
interpretation: [in, ter, pre, ta, tion]
interpreted: [in, ter, pre, ted]
interpreting: [in, ter, pre, ting]
interprets: [in, ter, prets]
interval: [in, ter, val]
interval's: [in, ter, vals]
intervals: [in, ter, vals]
intervention: [in, ter, ven, tion]
into: [in, to]
introduce: [in, tro, duce]
introduced: [in, tro, du, ced]
introduces: [in, tro, du, ces]
introducing: [in, tro, du, cing]
introduction: [in, tro, du, ction]
invalid: [in, va, lid]
invariably: [in, va, ria, bly]
invent: [in, vent]
invented: [in, ven, ted]
inventing: [in, ven, ting]
invents: [in, vents]
investigate: [in, ve, sti, gate]
invisible: [in, vi, si, ble]
invitation: [in, vi, ta, tion]
invite: [in, vite]
invited: [in, vi, ted]
invites: [in, vi, tes]
inviting: [in, vi, ting]
involve: [in, vol, ve]
involved: [in, vol, ved]
involves: [in, vol, ves]
involving: [in, vol, ving]
irrelevant: [i, rre, le, vant]
irritate: [i, rri, tate]
irritated: [i, rri, ta, ted]
irritates: [i, rri, ta, tes]
irritating: [i, rri, ta, ting]
is: [is]
isn't: [isnt]
isolate: [i, so, late]
isolated: [i, so, la, ted]
isolates: [i, so, la, tes]
isolating: [i, so, la, ting]
issue: [i, ssue]
issue's: [i, ssues]
issued: [i, ssued]
issues: [i, ssues]
issuing: [i, ssuing]
it: [it]
it's: [its]
item: [i, tem]
item's: [i, tems]
items: [i, tems]
its: [its]
itself: [i, tself]
job: [job]
job's: [jobs]
jobs: [jobs]
join: [join]
joined: [joi, ned]
joining: [joi, ning]
joins: [joins]
joint: [joint]
joke: [joke]
joy: [joy]
judge: [ju, dge]
judgement: [ju, dge, ment]
judgment: [ju, dgment]
jump: [jump]
jump's: [jumps]
jumps: [jumps]
junk: [junk]
just: [just]
justification: [ju, sti, fi, ca, tion]
justified: [ju, sti, fied]
justifies: [ju, sti, fies]
justify: [ju, sti, fy]
justifying: [ju, sti, fying]
keen: [keen]
keep: [keep]
keep's: [keeps]
keeping: [kee, ping]
keeps: [keeps]
kept: [kept]
key: [key]
key's: [keys]
keyboard: [key, board]
keys: [keys]
kid: [kid]
kill: [kill]
killed: [ki, lled]
killing: [ki, lling]
kills: [kills]
kind: [kind]
kind's: [kinds]
kindly: [kin, dly]
kinds: [kinds]
king: [king]
knew: [knew]
knock: [knock]
knocked: [kno, cked]
knocking: [kno, cking]
knocks: [knocks]
know: [know]
knowing: [kno, wing]
knowledge: [know, le, dge]
known: [known]
knows: [knows]
label: [la, bel]
label's: [la, bels]
labeled: [la, be, led]
labeling: [la, be, ling]
labelled: [la, be, lled]
labelling: [la, be, lling]
labels: [la, bels]
labor: [la, bor]
laboratory: [la, bo, ra, to, ry]
labour: [la, bour]
lack: [lack]
lacked: [la, cked]
lacking: [la, cking]
lacks: [lacks]
ladies: [la, dies]
lady: [la, dy]
lady's: [la, dys]
lain: [lain]
land: [land]
landed: [lan, ded]
landing: [lan, ding]
lands: [lands]
language: [lan, guage]
language's: [lan, gua, ges]
languages: [lan, gua, ges]
large: [lar, ge]
largely: [lar, ge, ly]
larger: [lar, ger]
largest: [lar, gest]
last: [last]
last's: [lasts]
lasts: [lasts]
late: [late]
later: [la, ter]
latest: [la, test]
latter: [la, tter]
law: [law]
law's: [laws]
laws: [laws]
lay: [lay]
layout: [la, yout]
lazy: [la, zy]
leach: [leach]
lead: [lead]
lead's: [leads]
leaded: [lea, ded]
leader: [lea, der]
leading: [lea, ding]
leads: [leads]
leaf: [leaf]
leaf's: [leafs]
learn: [learn]
learned: [lear, ned]
learning: [lear, ning]
learns: [learns]
learnt: [learnt]
least: [least]
leave: [leave]
leave's: [lea, ves]
leaved: [lea, ved]
leaves: [lea, ves]
leaving: [lea, ving]
lecture: [le, cture]
lecture's: [le, ctu, res]
lectures: [le, ctu, res]
led: [led]
left: [left]
leg: [leg]
leg's: [legs]
legal: [le, gal]
legally: [le, ga, lly]
legs: [legs]
lend: [lend]
length: [length]
less: [less]
less's: [lesss]
lesser: [le, sser]
lesson: [le, sson]
lesson's: [le, ssons]
lessons: [le, ssons]
let: [let]
let's: [lets]
lets: [lets]
letter: [le, tter]
letter's: [le, tters]
letters: [le, tters]
letting: [le, tting]
level: [le, vel]
level's: [le, vels]
levels: [le, vels]
liable: [lia, ble]
libraries: [li, bra, ries]
library: [li, bra, ry]
library's: [li, bra, rys]
lie: [lie]
lie's: [lies]
lied: [lied]
lies: [lies]
life: [life]
life's: [li, fes]
lifetime: [li, fe, time]
lift: [lift]
light: [light]
light's: [lights]
lights: [lights]
like: [like]
like's: [li, kes]
liked: [li, ked]
likely: [li, ke, ly]
likes: [li, kes]
likewise: [li, ke, wise]
liking: [li, king]
limit: [li, mit]
limit's: [li, mits]
limited: [li, mi, ted]
limiting: [li, mi, ting]
limits: [li, mits]
line: [line]
line's: [li, nes]
linear: [li, near]
lines: [li, nes]
link: [link]
link's: [links]
linked: [lin, ked]
linking: [lin, king]
links: [links]
list: [list]
list's: [lists]
listed: [li, sted]
listen: [li, sten]
listing: [li, sting]
lists: [lists]
literally: [li, te, ra, lly]
literature: [li, te, ra, ture]
little: [li, ttle]
live: [live]
lived: [li, ved]
lives: [li, ves]
living: [li, ving]
load: [load]
loaded: [loa, ded]
loading: [loa, ding]
loads: [loads]
loan: [loan]
local: [lo, cal]
location: [lo, ca, tion]
location's: [lo, ca, tions]
locations: [lo, ca, tions]
lock: [lock]
locked: [lo, cked]
locking: [lo, cking]
locks: [locks]
log: [log]
log's: [logs]
logged: [lo, gged]
logging: [lo, gging]
logic: [lo, gic]
logical: [lo, gi, cal]
logs: [logs]
long: [long]
longer: [lon, ger]
longest: [lon, gest]
look: [look]
look's: [looks]
looked: [loo, ked]
looking: [loo, king]
looks: [looks]
loop: [loop]
loose: [loose]
lorries: [lo, rries]
lorry: [lo, rry]
lorry's: [lo, rrys]
lose: [lose]
loses: [lo, ses]
losing: [lo, sing]
loss: [loss]
lost: [lost]
lot: [lot]
lot's: [lots]
lots: [lots]
loudly: [lou, dly]
love: [love]
low: [low]
lower: [lo, wer]
lowest: [lo, west]
luck: [luck]
lucky: [lu, cky]
lunch: [lunch]
lying: [lying]
machine: [ma, chine]
machine's: [ma, chi, nes]
machines: [ma, chi, nes]
mad: [mad]
made: [made]
magic: [ma, gic]
magnetic: [ma, gne, tic]
magnitude: [ma, gni, tude]
mail: [mail]
main: [main]
mainly: [mai, nly]
maintain: [main, tain]
maintained: [main, tai, ned]
maintaining: [main, tai, ning]
maintains: [main, tains]
major: [ma, jor]
majority: [ma, jo, ri, ty]
make: [make]
make's: [ma, kes]
makes: [ma, kes]
making: [ma, king]
man: [man]
man's: [mans]
manage: [ma, nage]
managed: [ma, na, ged]
manager: [ma, na, ger]
manages: [ma, na, ges]
managing: [ma, na, ging]
manipulation: [ma, ni, pu, la, tion]
manner: [ma, nner]
manual: [ma, nual]
manual's: [ma, nuals]
manuals: [ma, nuals]
many: [ma, ny]
map: [map]
march: [march]
mark: [mark]
mark's: [marks]
marked: [mar, ked]
market: [mar, ket]
marking: [mar, king]
marks: [marks]
marriage: [ma, rriage]
marry: [ma, rry]
mass: [mass]
massive: [ma, ssive]
master: [ma, ster]
match: [match]
match's: [matchs]
matches: [ma, tches]
material: [ma, te, rial]
material's: [ma, te, rials]
materials: [ma, te, rials]
mathematical: [ma, the, ma, ti, cal]
mathematics: [ma, the, ma, tics]
matter: [ma, tter]
matter's: [ma, tters]
matters: [ma, tters]
maximum: [ma, xi, mum]
may: [may]
maybe: [may, be]
me: [me]
mean: [mean]
mean's: [means]
meaning: [mea, ning]
meaning's: [mea, nings]
meaningful: [mea, nin, gful]
meaningless: [mea, nin, gless]
meanings: [mea, nings]
means: [means]
meant: [meant]
measure: [mea, sure]
measure's: [mea, su, res]
measured: [mea, su, red]
measures: [mea, su, res]
measuring: [mea, su, ring]
mechanic: [me, cha, nic]
mechanic's: [me, cha, nics]
mechanics: [me, cha, nics]
mechanism: [me, cha, nism]
media: [me, dia]
medical: [me, di, cal]
medium: [me, dium]
medium's: [me, diums]
mediums: [me, diums]
meet: [meet]
meet's: [meets]
meeting: [mee, ting]
meeting's: [mee, tings]
meetings: [mee, tings]
meets: [meets]
member: [mem, ber]
member's: [mem, bers]
members: [mem, bers]
membership: [mem, ber, ship]
memory: [me, mo, ry]
men: [men]
mention: [men, tion]
mention's: [men, tions]
mentioned: [men, tio, ned]
mentioning: [men, tio, ning]
mentions: [men, tions]
mere: [mere]
merely: [me, re, ly]
merit: [me, rit]
merit's: [me, rits]
merits: [me, rits]
mess: [mess]
message: [me, ssage]
message's: [me, ssa, ges]
messages: [me, ssa, ges]
messy: [me, ssy]
met: [met]
metal: [me, tal]
method: [me, thod]
method's: [me, thods]
methods: [me, thods]
middle: [mi, ddle]
midnight: [mi, dnight]
might: [might]
mile: [mile]
mile's: [mi, les]
miles: [mi, les]
military: [mi, li, ta, ry]
military's: [mi, li, ta, rys]
million: [mi, llion]
million's: [mi, llions]
millions: [mi, llions]
mind: [mind]
mind's: [minds]
minded: [min, ded]
minding: [min, ding]
minds: [minds]
mine: [mine]
minimal: [mi, ni, mal]
minimum: [mi, ni, mum]
minor: [mi, nor]
minority: [mi, no, ri, ty]
minute: [mi, nute]
minute's: [mi, nu, tes]
minutes: [mi, nu, tes]
mislead: [mi, slead]
misleading: [mi, slea, ding]
misleads: [mi, sleads]
misled: [mi, sled]
miss: [miss]
missed: [mi, ssed]
misses: [mi, sses]
missing: [mi, ssing]
mistake: [mi, stake]
mistake's: [mi, sta, kes]
mistaken: [mi, sta, ken]
mistakes: [mi, sta, kes]
mistaking: [mi, sta, king]
mistook: [mi, stook]
misunderstand: [mi, sun, der, stand]
misunderstanding: [mi, sun, der, stan, ding]
misunderstands: [mi, sun, der, stands]
misunderstood: [mi, sun, der, stood]
misuse: [mi, suse]
mix: [mix]
mixed: [mi, xed]
mixes: [mi, xes]
mixing: [mi, xing]
mod: [mod]
mode: [mode]
model: [mo, del]
model's: [mo, dels]
models: [mo, dels]
modern: [mo, dern]
modified: [mo, di, fied]
modifies: [mo, di, fies]
modify: [mo, di, fy]
modifying: [mo, di, fying]
moment: [mo, ment]
money: [mo, ney]
monitor: [mo, ni, tor]
month: [month]
month's: [months]
months: [months]
moral: [mo, ral]
more: [more]
morning: [mor, ning]
morning's: [mor, nings]
mornings: [mor, nings]
most: [most]
mostly: [mo, stly]
mother: [mo, ther]
motion: [mo, tion]
mouth: [mouth]
move: [move]
move's: [mo, ves]
moved: [mo, ved]
movement: [mo, ve, ment]
movement's: [mo, ve, ments]
movements: [mo, ve, ments]
moves: [mo, ves]
movie: [mo, vie]
moving: [mo, ving]
much: [much]
multiple: [mul, ti, ple]
music: [mu, sic]
must: [must]
my: [my]
myself: [my, self]
mysterious: [my, ste, rious]
naive: [naive]
name: [name]
name's: [na, mes]
named: [na, med]
namely: [na, me, ly]
names: [na, mes]
naming: [na, ming]
nasty: [na, sty]
nation: [na, tion]
national: [na, tio, nal]
natural: [na, tu, ral]
naturally: [na, tu, ra, lly]
nature: [na, ture]
naughty: [naugh, ty]
near: [near]
nearby: [near, by]
nearer: [nea, rer]
nearest: [nea, rest]
nearly: [near, ly]
necessarily: [ne, ce, ssa, ri, ly]
necessary: [ne, ce, ssa, ry]
necessity: [ne, ce, ssi, ty]
neck: [neck]
need: [need]
need's: [needs]
needed: [nee, ded]
needing: [nee, ding]
needs: [needs]
negative: [ne, ga, tive]
neither: [nei, ther]
nervous: [ner, vous]
net: [net]
network: [ne, twork]
network's: [ne, tworks]
networks: [ne, tworks]
never: [ne, ver]
nevertheless: [ne, ver, the, less]
new: [new]
news: [news]
next: [next]
nice: [nice]
nicer: [ni, cer]
nicest: [ni, cest]
night: [night]
nine: [nine]
no: [no]
nobody: [no, bo, dy]
noise: [noise]
noisy: [noi, sy]
none: [none]
nonsense: [non, sen, se]
nor: [nor]
normal: [nor, mal]
normally: [nor, ma, lly]
north: [north]
not: [not]
note: [note]
note's: [no, tes]
noted: [no, ted]
notes: [no, tes]
nothing: [no, thing]
notice: [no, tice]
notice's: [no, ti, ces]
noticed: [no, ti, ced]
notices: [no, ti, ces]
noticing: [no, ti, cing]
notify: [no, ti, fy]
noting: [no, ting]
novel: [no, vel]
now: [now]
nowadays: [no, wa, days]
nowhere: [no, where]
numb: [numb]
number: [num, ber]
number's: [num, bers]
numbers: [num, bers]
numbest: [num, best]
numerical: [nu, me, ri, cal]
numerous: [nu, me, rous]
obey: [o, bey]
object: [o, bject]
object's: [o, bjects]
objected: [o, bje, cted]
objecting: [o, bje, cting]
objection: [o, bje, ction]
objection's: [o, bje, ctions]
objections: [o, bje, ctions]
objects: [o, bjects]
obscure: [ob, scure]
observation: [o, bser, va, tion]
observe: [o, bser, ve]
observed: [o, bser, ved]
observes: [o, bser, ves]
observing: [o, bser, ving]
obtain: [o, btain]
obtained: [o, btai, ned]
obtaining: [o, btai, ning]
obtains: [o, btains]
obvious: [o, bvious]
obviously: [o, bviou, sly]
occasion: [o, cca, sion]
occasion's: [o, cca, sions]
occasional: [o, cca, sio, nal]
occasionally: [o, cca, sio, na, lly]
occasions: [o, cca, sions]
occupied: [o, ccu, pied]
occupies: [o, ccu, pies]
occupy: [o, ccu, py]
occupying: [o, ccu, pying]
occur: [o, ccur]
occurred: [o, ccu, rred]
occurring: [o, ccu, rring]
occurs: [o, ccurs]
odd: [odd]
odds: [odds]
of: [of]
off: [off]
offer: [o, ffer]
offer's: [o, ffers]
offered: [o, ffe, red]
offering: [o, ffe, ring]
offers: [o, ffers]
office: [o, ffice]
office's: [o, ffi, ces]
officer: [o, ffi, cer]
offices: [o, ffi, ces]
official: [o, ffi, cial]
often: [of, ten]
oh: [oh]
oil: [oil]
old: [old]
older: [ol, der]
oldest: [ol, dest]
omit: [o, mit]
omits: [o, mits]
omitted: [o, mi, tted]
omitting: [o, mi, tting]
on: [on]
once: [on, ce]
one: [one]
one's: [o, nes]
ones: [o, nes]
only: [o, nly]
onto: [on, to]
open: [o, pen]
open's: [o, pens]
opened: [o, pe, ned]
opening: [o, pe, ning]
opens: [o, pens]
operate: [o, pe, rate]
operated: [o, pe, ra, ted]
operates: [o, pe, ra, tes]
operating: [o, pe, ra, ting]
operation: [o, pe, ra, tion]
operation's: [o, pe, ra, tions]
operations: [o, pe, ra, tions]
operator: [o, pe, ra, tor]
operator's: [o, pe, ra, tors]
operators: [o, pe, ra, tors]
opinion: [o, pi, nion]
opinion's: [o, pi, nions]
opinions: [o, pi, nions]
opportunities: [o, ppor, tu, ni, ties]
opportunity: [o, ppor, tu, ni, ty]
opportunity's: [o, ppor, tu, ni, tys]
oppose: [o, ppose]
opposed: [o, ppo, sed]
opposes: [o, ppo, ses]
opposing: [o, ppo, sing]
opposite: [o, ppo, site]
opposition: [o, ppo, si, tion]
option: [o, ption]
option's: [o, ptions]
optional: [o, ptio, nal]
options: [o, ptions]
or: [or]
order: [or, der]
order's: [or, ders]
ordered: [or, de, red]
ordering: [or, de, ring]
orders: [or, ders]
ordinary: [or, di, na, ry]
organisation: [or, ga, ni, sa, tion]
organise: [or, ga, nise]
organised: [or, ga, ni, sed]
organises: [or, ga, ni, ses]
organising: [or, ga, ni, sing]
organization: [or, ga, ni, za, tion]
organize: [or, ga, nize]
organized: [or, ga, ni, zed]
organizes: [or, ga, ni, zes]
organizing: [or, ga, ni, zing]
origin: [o, ri, gin]
original: [o, ri, gi, nal]
originally: [o, ri, gi, na, lly]
other: [o, ther]
others: [o, thers]
otherwise: [o, the, rwise]
ought: [ought]
our: [our]
ours: [ours]
ourselves: [our, sel, ves]
out: [out]
outer: [ou, ter]
output: [ou, tput]
outside: [ou, tside]
over: [o, ver]
overall: [o, ve, rall]
owe: [owe]
owed: [o, wed]
owes: [o, wes]
owing: [o, wing]
own: [own]
owner: [ow, ner]
owner's: [ow, ners]
owners: [ow, ners]
pack: [pack]
package: [pa, ckage]
package's: [pa, cka, ges]
packages: [pa, cka, ges]
packet: [pa, cket]
page: [page]
page's: [pa, ges]
pages: [pa, ges]
paid: [paid]
pain: [pain]
painful: [pain, ful]
pair: [pair]
pair's: [pairs]
pairs: [pairs]
paper: [pa, per]
paper's: [pa, pers]
papers: [pa, pers]
paragraph: [pa, ra, graph]
parallel: [pa, ra, llel]
parent: [pa, rent]
park: [park]
part: [part]
part's: [parts]
partial: [par, tial]
partially: [par, tia, lly]
particular: [par, ti, cu, lar]
particularly: [par, ti, cu, lar, ly]
parties: [par, ties]
partly: [par, tly]
parts: [parts]
party: [par, ty]
party's: [par, tys]
pass: [pass]
passed: [pa, ssed]
passes: [pa, sses]
passing: [pa, ssing]
past: [past]
patch: [patch]
path: [path]
patient: [pa, tient]
pattern: [pa, ttern]
pattern's: [pa, tterns]
patterns: [pa, tterns]
pause: [pause]
pay: [pay]
payed: [pa, yed]
paying: [pa, ying]
pays: [pays]
peace: [peace]
peak: [peak]
peculiar: [pe, cu, liar]
pen: [pen]
people: [peo, ple]
per: [per]
perfect: [per, fect]
perfectly: [per, fe, ctly]
perform: [per, form]
performance: [per, for, man, ce]
performed: [per, for, med]
performing: [per, for, ming]
performs: [per, forms]
perhaps: [per, haps]
period: [pe, riod]
permanent: [per, ma, nent]
permanently: [per, ma, nen, tly]
permission: [per, mi, ssion]
permit: [per, mit]
permits: [per, mits]
permitted: [per, mi, tted]
permitting: [per, mi, tting]
person: [per, son]
person's: [per, sons]
personal: [per, so, nal]
personally: [per, so, na, lly]
persons: [per, sons]
persuade: [per, suade]
persuaded: [per, sua, ded]
persuades: [per, sua, des]
persuading: [per, sua, ding]
petrol: [pe, trol]
phase: [phase]
phenomenon: [phe, no, me, non]
philosophy: [phi, lo, so, phy]
phone: [phone]
phrase: [phrase]
phrase's: [phra, ses]
phrases: [phra, ses]
physical: [phy, si, cal]
pi: [pi]
pick: [pick]
picked: [pi, cked]
picking: [pi, cking]
picks: [picks]
picture: [pi, cture]
picture's: [pi, ctu, res]
pictures: [pi, ctu, res]
piece: [piece]
piece's: [pie, ces]
pieces: [pie, ces]
pile: [pile]
pint: [pint]
pipe: [pipe]
place: [place]
place's: [pla, ces]
placed: [pla, ced]
places: [pla, ces]
placing: [pla, cing]
plain: [plain]
plan: [plan]
plan's: [plans]
plane: [plane]
planet: [pla, net]
planned: [pla, nned]
planning: [pla, nning]
plans: [plans]
plant: [plant]
plastic: [pla, stic]
play: [play]
played: [pla, yed]
playing: [pla, ying]
plays: [plays]
plea: [plea]
pleasant: [plea, sant]
please: [please]
pleased: [plea, sed]
pleases: [plea, ses]
pleasing: [plea, sing]
plenty: [plen, ty]
plot: [plot]
plot's: [plots]
plots: [plots]
plug: [plug]
plus: [plus]
pocket: [po, cket]
poem: [poem]
poet: [poet]
point: [point]
point's: [points]
pointed: [poin, ted]
pointing: [poin, ting]
pointless: [poin, tless]
points: [points]
police: [po, lice]
police's: [po, li, ces]
policies: [po, li, cies]
policy: [po, li, cy]
policy's: [po, li, cys]
political: [po, li, ti, cal]
poll: [poll]
pool: [pool]
poor: [poor]
pop: [pop]
popular: [po, pu, lar]
population: [po, pu, la, tion]
port: [port]
position: [po, si, tion]
position's: [po, si, tions]
positions: [po, si, tions]
positive: [po, si, tive]
possibilities: [po, ssi, bi, li, ties]
possibility: [po, ssi, bi, li, ty]
possibility's: [po, ssi, bi, li, tys]
possible: [po, ssi, ble]
possibly: [po, ssi, bly]
post: [post]
posted: [po, sted]
posting: [po, sting]
postmaster: [po, stma, ster]
posts: [posts]
potential: [po, ten, tial]
potentially: [po, ten, tia, lly]
pound: [pound]
pound's: [pounds]
pounds: [pounds]
power: [po, wer]
power's: [po, wers]
powerful: [po, wer, ful]
powers: [po, wers]
practical: [pra, cti, cal]
practically: [pra, cti, ca, lly]
practice: [pra, ctice]
practise: [pra, ctise]
precise: [pre, cise]
precisely: [pre, ci, se, ly]
prefer: [pre, fer]
preferable: [pre, fe, ra, ble]
preferably: [pre, fe, ra, bly]
preference: [pre, fe, ren, ce]
preferred: [pre, fe, rred]
preferring: [pre, fe, rring]
prefers: [pre, fers]
preparation: [pre, pa, ra, tion]
prepare: [pre, pare]
prepared: [pre, pa, red]
prepares: [pre, pa, res]
preparing: [pre, pa, ring]
presence: [pre, sen, ce]
present: [pre, sent]
present's: [pre, sents]
presented: [pre, sen, ted]
presenting: [pre, sen, ting]
presents: [pre, sents]
preserve: [pre, ser, ve]
president: [pre, si, dent]
press: [press]
pressed: [pre, ssed]
presses: [pre, sses]
pressing: [pre, ssing]
pressure: [pre, ssure]
presumably: [pre, su, ma, bly]
presume: [pre, sume]
pretty: [pre, tty]
prevent: [pre, vent]
prevented: [pre, ven, ted]
preventing: [pre, ven, ting]
prevents: [pre, vents]
previous: [pre, vious]
previously: [pre, viou, sly]
price: [price]
price's: [pri, ces]
prices: [pri, ces]
primary: [pri, ma, ry]
prime: [prime]
primitive: [pri, mi, tive]
principle: [prin, ci, ple]
principle's: [prin, ci, ples]
principles: [prin, ci, ples]
print: [print]
printed: [prin, ted]
printer: [prin, ter]
printer's: [prin, ters]
printers: [prin, ters]
printing: [prin, ting]
printout: [prin, tout]
prints: [prints]
prior: [prior]
private: [pri, vate]
probably: [pro, ba, bly]
problem: [pro, blem]
problem's: [pro, blems]
problems: [pro, blems]
procedure: [pro, ce, dure]
process: [pro, cess]
process's: [pro, cesss]
processed: [pro, ce, ssed]
processes: [pro, ce, sses]
processing: [pro, ce, ssing]
processor: [pro, ce, ssor]
processor's: [pro, ce, ssors]
processors: [pro, ce, ssors]
produce: [pro, duce]
produced: [pro, du, ced]
produces: [pro, du, ces]
producing: [pro, du, cing]
product: [pro, duct]
product's: [pro, ducts]
production: [pro, du, ction]
products: [pro, ducts]
professional: [pro, fe, ssio, nal]
program: [pro, gram]
program's: [pro, grams]
programme: [pro, gra, mme]
programme's: [pro, gra, mmes]
programmed: [pro, gra, mmed]
programmer: [pro, gra, mmer]
programmer's: [pro, gra, mmers]
programmers: [pro, gra, mmers]
programmes: [pro, gra, mmes]
programming: [pro, gra, mming]
programs: [pro, grams]
progress: [pro, gress]
project: [pro, ject]
project's: [pro, jects]
projects: [pro, jects]
promise: [pro, mise]
promised: [pro, mi, sed]
promises: [pro, mi, ses]
promising: [pro, mi, sing]
prompt: [prompt]
promptly: [prom, ptly]
prone: [prone]
proof: [proof]
proper: [pro, per]
properly: [pro, per, ly]
properties: [pro, per, ties]
property: [pro, per, ty]
property's: [pro, per, tys]
proportion: [pro, por, tion]
proposal: [pro, po, sal]
propose: [pro, pose]
proposed: [pro, po, sed]
proposes: [pro, po, ses]
proposing: [pro, po, sing]
prospect: [pro, spect]
protect: [pro, tect]
protected: [pro, te, cted]
protecting: [pro, te, cting]
protection: [pro, te, ction]
protects: [pro, tects]
protest: [pro, test]
prove: [prove]
proved: [pro, ved]
proves: [pro, ves]
provide: [pro, vide]
provided: [pro, vi, ded]
provides: [pro, vi, des]
providing: [pro, vi, ding]
proving: [pro, ving]
public: [pu, blic]
publication: [pu, bli, ca, tion]
publicity: [pu, bli, ci, ty]
publicly: [pu, bli, cly]
publish: [pu, blish]
published: [pu, bli, shed]
publishes: [pu, bli, shes]
publishing: [pu, bli, shing]
pull: [pull]
pulled: [pu, lled]
pulling: [pu, lling]
pulls: [pulls]
punctuation: [pun, ctua, tion]
puncture: [pun, cture]
purchase: [pur, chase]
pure: [pure]
purely: [pu, re, ly]
purpose: [pur, pose]
purpose's: [pur, po, ses]
purposes: [pur, po, ses]
push: [push]
pushed: [pu, shed]
pushes: [pu, shes]
pushing: [pu, shing]
put: [put]
put's: [puts]
puts: [puts]
putt: [putt]
putted: [pu, tted]
putting: [pu, tting]
putts: [putts]
qualified: [qua, li, fied]
qualifies: [qua, li, fies]
qualify: [qua, li, fy]
qualifying: [qua, li, fying]
quality: [qua, li, ty]
quantities: [quan, ti, ties]
quantity: [quan, ti, ty]
quantity's: [quan, ti, tys]
quarter: [quar, ter]
question: [que, stion]
question's: [que, stions]
questions: [que, stions]
queue: [queue]
quick: [quick]
quicker: [qui, cker]
quickest: [qui, ckest]
quickly: [qui, ckly]
quiet: [quiet]
quietly: [quie, tly]
quit: [quit]
quite: [quite]
quits: [quits]
quitting: [qui, tting]
quote: [quote]
quote's: [quo, tes]
quoted: [quo, ted]
quotes: [quo, tes]
quoting: [quo, ting]
race: [race]
radio: [ra, dio]
rain: [rain]
raise: [raise]
raised: [rai, sed]
raises: [rai, ses]
raising: [rai, sing]
ran: [ran]
random: [ran, dom]
randomly: [ran, do, mly]
range: [ran, ge]
rapid: [ra, pid]
rapidly: [ra, pi, dly]
rare: [rare]
rarely: [ra, re, ly]
rate: [rate]
rate's: [ra, tes]
rates: [ra, tes]
rather: [ra, ther]
raw: [raw]
re: [re]
reach: [reach]
reach's: [reachs]
reached: [rea, ched]
reaches: [rea, ches]
reaching: [rea, ching]
react: [react]
reaction: [rea, ction]
read: [read]
read's: [reads]
readable: [rea, da, ble]
reader: [rea, der]
reader's: [rea, ders]
readers: [rea, ders]
readily: [rea, di, ly]
reading: [rea, ding]
reads: [reads]
ready: [rea, dy]
real: [real]
realise: [rea, lise]
realised: [rea, li, sed]
realises: [rea, li, ses]
realising: [rea, li, sing]
reality: [rea, li, ty]
realize: [rea, lize]
realized: [rea, li, zed]
realizes: [rea, li, zes]
realizing: [rea, li, zing]
really: [rea, lly]
reason: [rea, son]
reason's: [rea, sons]
reasonable: [rea, so, na, ble]
reasonably: [rea, so, na, bly]
reasons: [rea, sons]
recall: [re, call]
receive: [re, ceive]
received: [re, cei, ved]
receives: [re, cei, ves]
receiving: [re, cei, ving]
recent: [re, cent]
recently: [re, cen, tly]
reception: [re, ce, ption]
recognise: [re, co, gnise]
recognised: [re, co, gni, sed]
recognises: [re, co, gni, ses]
recognising: [re, co, gni, sing]
recognition: [re, co, gni, tion]
recognize: [re, co, gnize]
recognized: [re, co, gni, zed]
recognizes: [re, co, gni, zes]
recognizing: [re, co, gni, zing]
recommend: [re, co, mmend]
recommendation: [re, co, mmen, da, tion]
recommended: [re, co, mmen, ded]
recommending: [re, co, mmen, ding]
recommends: [re, co, mmends]
record: [re, cord]
record's: [re, cords]
recorded: [re, cor, ded]
recording: [re, cor, ding]
records: [re, cords]
recover: [re, co, ver]
recovered: [re, co, ve, red]
recovering: [re, co, ve, ring]
recovers: [re, co, vers]
red: [red]
reduce: [re, duce]
reduced: [re, du, ced]
reduces: [re, du, ces]
reducing: [re, du, cing]
reduction: [re, du, ction]
redundant: [re, dun, dant]
refer: [re, fer]
reference: [re, fe, ren, ce]
reference's: [re, fe, ren, ces]
references: [re, fe, ren, ces]
referred: [re, fe, rred]
referring: [re, fe, rring]
refers: [re, fers]
reflect: [re, flect]
reflected: [re, fle, cted]
reflecting: [re, fle, cting]
reflection: [re, fle, ction]
reflects: [re, flects]
refuse: [re, fuse]
refused: [re, fu, sed]
refuses: [re, fu, ses]
refusing: [re, fu, sing]
regard: [re, gard]
regarded: [re, gar, ded]
regarding: [re, gar, ding]
regardless: [re, gar, dless]
regards: [re, gards]
region: [re, gion]
register: [re, gi, ster]
registered: [re, gi, ste, red]
registering: [re, gi, ste, ring]
registers: [re, gi, sters]
regret: [re, gret]
regular: [re, gu, lar]
regularly: [re, gu, lar, ly]
regulation: [re, gu, la, tion]
regulation's: [re, gu, la, tions]
regulations: [re, gu, la, tions]
reject: [re, ject]
rejected: [re, je, cted]
rejecting: [re, je, cting]
rejects: [re, jects]
relate: [re, late]
related: [re, la, ted]
relates: [re, la, tes]
relating: [re, la, ting]
relation: [re, la, tion]
relationship: [re, la, tion, ship]
relative: [re, la, tive]
relatively: [re, la, ti, ve, ly]
release: [re, lease]
release's: [re, lea, ses]
released: [re, lea, sed]
releases: [re, lea, ses]
releasing: [re, lea, sing]
relevance: [re, le, van, ce]
relevant: [re, le, vant]
reliable: [re, lia, ble]
religion: [re, li, gion]
religious: [re, li, gious]
religious's: [re, li, giouss]
reluctant: [re, lu, ctant]
rely: [re, ly]
remain: [re, main]
remained: [re, mai, ned]
remaining: [re, mai, ning]
remains: [re, mains]
remark: [re, mark]
remark's: [re, marks]
remarks: [re, marks]
remember: [re, mem, ber]
remembered: [re, mem, be, red]
remembering: [re, mem, be, ring]
remembers: [re, mem, bers]
remind: [re, mind]
reminded: [re, min, ded]
reminding: [re, min, ding]
reminds: [re, minds]
remote: [re, mote]
remotely: [re, mo, te, ly]
removal: [re, mo, val]
remove: [re, move]
removed: [re, mo, ved]
removes: [re, mo, ves]
removing: [re, mo, ving]
repair: [re, pair]
repeat: [re, peat]
repeated: [re, pea, ted]
repeatedly: [re, pea, te, dly]
repeating: [re, pea, ting]
repeats: [re, peats]
replace: [re, place]
replaced: [re, pla, ced]
replacement: [re, pla, ce, ment]
replaces: [re, pla, ces]
replacing: [re, pla, cing]
replied: [re, plied]
replies: [re, plies]
reply: [re, ply]
reply's: [re, plys]
replying: [re, plying]
report: [re, port]
report's: [re, ports]
reported: [re, por, ted]
reporting: [re, por, ting]
reports: [re, ports]
represent: [re, pre, sent]
representation: [re, pre, sen, ta, tion]
representative: [re, pre, sen, ta, tive]
represented: [re, pre, sen, ted]
representing: [re, pre, sen, ting]
represents: [re, pre, sents]
reproduce: [re, pro, duce]
request: [re, quest]
request's: [re, quests]
requested: [re, que, sted]
requesting: [re, que, sting]
requests: [re, quests]
require: [re, quire]
required: [re, qui, red]
requirement: [re, qui, re, ment]
requirement's: [re, qui, re, ments]
requirements: [re, qui, re, ments]
requires: [re, qui, res]
requiring: [re, qui, ring]
research: [re, search]
reserve: [re, ser, ve]
reserved: [re, ser, ved]
reserves: [re, ser, ves]
reserving: [re, ser, ving]
resident: [re, si, dent]
resolution: [re, so, lu, tion]
resort: [re, sort]
resource: [re, sour, ce]
resource's: [re, sour, ces]
resources: [re, sour, ces]
respect: [re, spect]
respect's: [re, spects]
respectively: [re, spe, cti, ve, ly]
respects: [re, spects]
respond: [re, spond]
response: [re, spon, se]
response's: [re, spon, ses]
responses: [re, spon, ses]
responsibility: [re, spon, si, bi, li, ty]
responsible: [re, spon, si, ble]
rest: [rest]
restart: [re, start]
restore: [re, store]
restored: [re, sto, red]
restores: [re, sto, res]
restoring: [re, sto, ring]
restrict: [re, strict]
restricted: [re, stri, cted]
restricting: [re, stri, cting]
restricts: [re, stricts]
result: [re, sult]
result's: [re, sults]
resulted: [re, sul, ted]
resulting: [re, sul, ting]
results: [re, sults]
retain: [re, tain]
return: [re, turn]
return's: [re, turns]
returned: [re, tur, ned]
returning: [re, tur, ning]
returns: [re, turns]
reveal: [re, veal]
revealed: [re, vea, led]
revealing: [re, vea, ling]
reveals: [re, veals]
reverse: [re, ver, se]
review: [re, view]
rewrite: [rew, rite]
rid: [rid]
ridding: [ri, dding]
ride: [ride]
ridiculous: [ri, di, cu, lous]
rids: [rids]
right: [right]
right's: [rights]
rights: [rights]
ring: [ring]
rise: [rise]
risk: [risk]
river: [ri, ver]
road: [road]
role: [role]
roll: [roll]
room: [room]
room's: [rooms]
rooms: [rooms]
root: [root]
rough: [rough]
roughly: [rou, ghly]
round: [round]
route: [route]
routine: [rou, tine]
row: [row]
rubber: [ru, bber]
rubbish: [ru, bbish]
rule: [rule]
rule's: [ru, les]
rules: [ru, les]
rumor: [ru, mor]
rumour: [ru, mour]
run: [run]
run's: [runs]
running: [ru, nning]
runs: [runs]
rush: [rush]
sad: [sad]
sadly: [sa, dly]
safe: [safe]
safely: [sa, fe, ly]
safer: [sa, fer]
safest: [sa, fest]
safety: [sa, fe, ty]
said: [said]
saint: [saint]
sake: [sake]
saki: [sa, ki]
sale: [sale]
sale's: [sa, les]
sales: [sa, les]
same: [same]
sample: [sam, ple]
sat: [sat]
satisfied: [sa, ti, sfied]
satisfies: [sa, ti, sfies]
satisfy: [sa, ti, sfy]
satisfying: [sa, ti, sfying]
save: [save]
saved: [sa, ved]
saves: [sa, ves]
saving: [sa, ving]
saw: [saw]
say: [say]
saying: [sa, ying]
says: [says]
scale: [scale]
scan: [scan]
scene: [scene]
scheme: [scheme]
school: [school]
school's: [schools]
schools: [schools]
science: [scien, ce]
science's: [scien, ces]
sciences: [scien, ces]
scientific: [scien, ti, fic]
score: [score]
score's: [sco, res]
scores: [sco, res]
scrap: [scrap]
scratch: [scratch]
screen: [screen]
screen's: [screens]
screens: [screens]
script: [script]
search: [search]
searched: [sear, ched]
searches: [sear, ches]
searching: [sear, ching]
season: [sea, son]
second: [se, cond]
second's: [se, conds]
secondary: [se, con, da, ry]
secondly: [se, con, dly]
seconds: [se, conds]
secret: [se, cret]
secretary: [se, cre, ta, ry]
section: [se, ction]
section's: [se, ctions]
sections: [se, ctions]
secure: [se, cure]
security: [se, cu, ri, ty]
see: [see]
see's: [sees]
seeing: [seeing]
seek: [seek]
seeking: [see, king]
seeks: [seeks]
seem: [seem]
seemed: [see, med]
seeming: [see, ming]
seems: [seems]
seen: [seen]
sees: [sees]
select: [se, lect]
selected: [se, le, cted]
selecting: [se, le, cting]
selection: [se, le, ction]
selects: [se, lects]
self: [self]
sell: [sell]
selling: [se, lling]
sells: [sells]
seminar: [se, mi, nar]
send: [send]
sending: [sen, ding]
sends: [sends]
senior: [se, nior]
sense: [sen, se]
sensible: [sen, si, ble]
sensibly: [sen, si, bly]
sensitive: [sen, si, tive]
sent: [sent]
sentence: [sen, ten, ce]
sentence's: [sen, ten, ces]
sentences: [sen, ten, ces]
separate: [se, pa, rate]
separately: [se, pa, ra, te, ly]
sequence: [se, quen, ce]
sequence's: [se, quen, ces]
sequences: [se, quen, ces]
serial: [se, rial]
series: [se, ries]
serious: [se, rious]
seriously: [se, riou, sly]
serve: [ser, ve]
serve's: [ser, ves]
served: [ser, ved]
server: [ser, ver]
serves: [ser, ves]
service: [ser, vice]
service's: [ser, vi, ces]
services: [ser, vi, ces]
serving: [ser, ving]
session: [se, ssion]
session's: [se, ssions]
sessions: [se, ssions]
set: [set]
set's: [sets]
sets: [sets]
setting: [se, tting]
settle: [se, ttle]
settled: [se, ttled]
settles: [se, ttles]
settling: [se, ttling]
seven: [se, ven]
several: [se, ve, ral]
severe: [se, vere]
severely: [se, ve, re, ly]
sex: [sex]
shall: [shall]
shame: [shame]
shape: [shape]
share: [share]
share's: [sha, res]
shared: [sha, red]
shares: [sha, res]
sharing: [sha, ring]
sharp: [sharp]
she: [she]
sheet: [sheet]
shelf: [shelf]
shell: [shell]
shift: [shift]
ship: [ship]
shoot: [shoot]
shop: [shop]
shopped: [sho, pped]
shopping: [sho, pping]
shops: [shops]
short: [short]
shortage: [shor, tage]
shorter: [shor, ter]
shortest: [shor, test]
shortly: [shor, tly]
should: [should]
show: [show]
show's: [shows]
showed: [sho, wed]
showing: [sho, wing]
shown: [shown]
shows: [shows]
shut: [shut]
shuts: [shuts]
shutting: [shu, tting]
side: [side]
side's: [si, des]
sides: [si, des]
sight: [sight]
sign: [sign]
sign's: [signs]
signal: [si, gnal]
signal's: [si, gnals]
signals: [si, gnals]
signed: [si, gned]
significance: [si, gni, fi, can, ce]
significant: [si, gni, fi, cant]
significantly: [si, gni, fi, can, tly]
signing: [si, gning]
signs: [signs]
silly: [si, lly]
similar: [si, mi, lar]
similarly: [si, mi, lar, ly]
simple: [sim, ple]
simpler: [sim, pler]
simplest: [sim, plest]
simply: [sim, ply]
simultaneous: [si, mul, ta, neous]
simultaneously: [si, mul, ta, neou, sly]
since: [sin, ce]
sincerely: [sin, ce, re, ly]
single: [sin, gle]
sit: [sit]
site: [site]
site's: [si, tes]
sites: [si, tes]
sits: [sits]
sitting: [si, tting]
situation: [si, tua, tion]
situation's: [si, tua, tions]
situations: [si, tua, tions]
six: [six]
size: [size]
size's: [si, zes]
sizes: [si, zes]
skill: [skill]
skill's: [skills]
skills: [skills]
sleep: [sleep]
slight: [slight]
slightly: [sligh, tly]
slip: [slip]
slow: [slow]
slower: [slo, wer]
slowest: [slo, west]
slowly: [slow, ly]
small: [small]
smaller: [sma, ller]
smallest: [sma, llest]
smile: [smile]
smooth: [smooth]
so: [so]
social: [so, cial]
society: [so, cie, ty]
soft: [soft]
software: [sof, tware]
sold: [sold]
solely: [so, le, ly]
solid: [so, lid]
solution: [so, lu, tion]
solution's: [so, lu, tions]
solutions: [so, lu, tions]
solve: [sol, ve]
solved: [sol, ved]
solves: [sol, ves]
solving: [sol, ving]
some: [some]
somebody: [so, me, bo, dy]
somehow: [so, me, how]
someone: [so, meone]
someplace: [so, me, place]
something: [so, me, thing]
sometime: [so, me, time]
sometimes: [so, me, ti, mes]
somewhat: [so, me, what]
somewhere: [so, me, where]
son: [son]
soon: [soon]
sooner: [soo, ner]
soonest: [soo, nest]
sophisticate: [so, phi, sti, cate]
sophisticated: [so, phi, sti, ca, ted]
sophisticates: [so, phi, sti, ca, tes]
sophisticating: [so, phi, sti, ca, ting]
sorry: [so, rry]
sort: [sort]
sort's: [sorts]
sorted: [sor, ted]
sorting: [sor, ting]
sorts: [sorts]
sought: [sought]
sound: [sound]
sound's: [sounds]
sounded: [soun, ded]
sounding: [soun, ding]
sounds: [sounds]
source: [sour, ce]
source's: [sour, ces]
sources: [sour, ces]
south: [south]
southern: [sou, thern]
space: [space]
space's: [spa, ces]
spaces: [spa, ces]
spare: [spare]
speak: [speak]
speaker: [spea, ker]
speaker's: [spea, kers]
speakers: [spea, kers]
speaking: [spea, king]
speaks: [speaks]
special: [spe, cial]
specially: [spe, cia, lly]
specific: [spe, ci, fic]
specifically: [spe, ci, fi, ca, lly]
specified: [spe, ci, fied]
specifies: [spe, ci, fies]
specify: [spe, ci, fy]
specifying: [spe, ci, fying]
speech: [speech]
speed: [speed]
spell: [spell]
spelled: [spe, lled]
spelling: [spe, lling]
spells: [spells]
spelt: [spelt]
spend: [spend]
spending: [spen, ding]
spends: [spends]
spent: [spent]
spirit: [spi, rit]
spite: [spite]
split: [split]
splits: [splits]
splitting: [spli, tting]
spoke: [spoke]
spoken: [spo, ken]
spot: [spot]
spots: [spots]
spotted: [spo, tted]
spotting: [spo, tting]
spread: [spread]
spreading: [sprea, ding]
spreads: [spreads]
spring: [spring]
square: [square]
stable: [sta, ble]
staff: [staff]
stage: [stage]
stage's: [sta, ges]
stages: [sta, ges]
stand: [stand]
stand's: [stands]
standard: [stan, dard]
standard's: [stan, dards]
standards: [stan, dards]
standing: [stan, ding]
stands: [stands]
start: [start]
start's: [starts]
started: [star, ted]
starting: [star, ting]
starts: [starts]
state: [state]
state's: [sta, tes]
stated: [sta, ted]
statement: [sta, te, ment]
statement's: [sta, te, ments]
statements: [sta, te, ments]
states: [sta, tes]
stating: [sta, ting]
station: [sta, tion]
station's: [sta, tions]
stations: [sta, tions]
statistic: [sta, ti, stic]
statistic's: [sta, ti, stics]
statistical: [sta, ti, sti, cal]
statistics: [sta, ti, stics]
status: [sta, tus]
stay: [stay]
stayed: [sta, yed]
staying: [sta, ying]
stays: [stays]
steal: [steal]
step: [step]
stick: [stick]
sticking: [sti, cking]
sticks: [sticks]
still: [still]
stock: [stock]
stone: [stone]
stone's: [sto, nes]
stones: [sto, nes]
stood: [stood]
stop: [stop]
stop's: [stops]
stopped: [sto, pped]
stopping: [sto, pping]
stops: [stops]
storage: [sto, rage]
store: [store]
stored: [sto, red]
stores: [sto, res]
storey: [sto, rey]
storing: [sto, ring]
story: [sto, ry]
straight: [straight]
straightforward: [straigh, tfo, rward]
strange: [stran, ge]
strategy: [stra, te, gy]
stream: [stream]
street: [street]
strength: [strength]
strict: [strict]
strictly: [stri, ctly]
strike: [strike]
strike's: [stri, kes]
strikes: [stri, kes]
striking: [stri, king]
string: [string]
string's: [strings]
strings: [strings]
strong: [strong]
strongly: [stron, gly]
struck: [struck]
structure: [stru, cture]
structure's: [stru, ctu, res]
structures: [stru, ctu, res]
stuck: [stuck]
student: [stu, dent]
student's: [stu, dents]
students: [stu, dents]
studied: [stu, died]
studies: [stu, dies]
study: [stu, dy]
study's: [stu, dys]
studying: [stu, dying]
stuff: [stuff]
stupid: [stu, pid]
style: [sty, le]
subject: [su, bject]
subject's: [su, bjects]
subjects: [su, bjects]
submit: [su, bmit]
submits: [su, bmits]
submitted: [su, bmi, tted]
submitting: [su, bmi, tting]
subsequent: [su, bse, quent]
subset: [su, bset]
substantial: [sub, stan, tial]
substitute: [sub, sti, tute]
subtle: [su, btle]
succeed: [su, cceed]
success: [su, ccess]
successful: [su, cce, ssful]
successfully: [su, cce, ssfu, lly]
such: [such]
sudden: [su, dden]
suddenly: [su, dde, nly]
suffer: [su, ffer]
suffered: [su, ffe, red]
suffering: [su, ffe, ring]
suffers: [su, ffers]
suffice: [su, ffice]
sufficient: [su, ffi, cient]
sufficiently: [su, ffi, cien, tly]
sugar: [su, gar]
suggest: [su, ggest]
suggested: [su, gge, sted]
suggesting: [su, gge, sting]
suggestion: [su, gge, stion]
suggestion's: [su, gge, stions]
suggestions: [su, gge, stions]
suggests: [su, ggests]
suit: [suit]
suitable: [sui, ta, ble]
suitably: [sui, ta, bly]
suited: [sui, ted]
suiting: [sui, ting]
suits: [suits]
sum: [sum]
summary: [su, mma, ry]
summer: [su, mmer]
sun: [sun]
superior: [su, pe, rior]
supervisor: [su, per, vi, sor]
supplied: [su, pplied]
supplies: [su, pplies]
supply: [su, pply]
supply's: [su, pplys]
supplying: [su, pplying]
support: [su, pport]
supported: [su, ppor, ted]
supporting: [su, ppor, ting]
supports: [su, pports]
suppose: [su, ppose]
supposed: [su, ppo, sed]
supposedly: [su, ppo, se, dly]
supposes: [su, ppo, ses]
supposing: [su, ppo, sing]
sure: [sure]
surely: [su, re, ly]
surface: [sur, face]
surprise: [sur, prise]
surprised: [sur, pri, sed]
surprises: [sur, pri, ses]
surprising: [sur, pri, sing]
survey: [sur, vey]
survive: [sur, vive]
survived: [sur, vi, ved]
survives: [sur, vi, ves]
surviving: [sur, vi, ving]
suspect: [su, spect]
suspected: [su, spe, cted]
suspecting: [su, spe, cting]
suspects: [su, spects]
suspend: [su, spend]
suspended: [su, spen, ded]
suspending: [su, spen, ding]
suspends: [su, spends]
suspicion: [su, spi, cion]
switch: [switch]
switch's: [switchs]
switched: [swi, tched]
switches: [swi, tches]
switching: [swi, tching]
symbol: [sym, bol]
symbol's: [sym, bols]
symbols: [sym, bols]
syntax: [syn, tax]
system: [sy, stem]
system's: [sy, stems]
systems: [sy, stems]
table: [ta, ble]
table's: [ta, bles]
tables: [ta, bles]
take: [take]
take's: [ta, kes]
taken: [ta, ken]
takes: [ta, kes]
taking: [ta, king]
talk: [talk]
talk's: [talks]
talked: [tal, ked]
talking: [tal, king]
talks: [talks]
tank: [tank]
tank's: [tanks]
tanks: [tanks]
tape: [tape]
tape's: [ta, pes]
tapes: [ta, pes]
target: [tar, get]
task: [task]
task's: [tasks]
tasks: [tasks]
taste: [ta, ste]
taught: [taught]
tax: [tax]
tea: [tea]
teach: [teach]
teacher: [tea, cher]
teaches: [tea, ches]
teaching: [tea, ching]
team: [team]
technical: [te, chni, cal]
technique: [te, chni, que]
technique's: [te, chni, ques]
techniques: [te, chni, ques]
technology: [te, chno, lo, gy]
tedious: [te, dious]
teeth: [teeth]
telephone: [te, le, phone]
television: [te, le, vi, sion]
tell: [tell]
telling: [te, lling]
tells: [tells]
temperature: [tem, pe, ra, ture]
temporarily: [tem, po, ra, ri, ly]
temporary: [tem, po, ra, ry]
ten: [ten]
tend: [tend]
tendency: [ten, den, cy]
tends: [tends]
term: [term]
term's: [terms]
terminal: [ter, mi, nal]
terminal's: [ter, mi, nals]
terminals: [ter, mi, nals]
terminology: [ter, mi, no, lo, gy]
terms: [terms]
terribly: [te, rri, bly]
test: [test]
test's: [tests]
tested: [te, sted]
testing: [te, sting]
tests: [tests]
text: [text]
than: [than]
thank: [thank]
thanks: [thanks]
that: [that]
that's: [thats]
the: [the]
their: [their]
them: [them]
themselves: [them, sel, ves]
then: [then]
theoretical: [theo, re, ti, cal]
theory: [theo, ry]
there: [there]
there's: [the, res]
thereby: [the, re, by]
therefore: [the, re, fore]
these: [these]
they: [they]
they're: [they, re]
thin: [thin]
thing: [thing]
thing's: [things]
things: [things]
think: [think]
thinking: [thin, king]
thinks: [thinks]
third: [third]
this: [this]
thoroughly: [tho, rou, ghly]
those: [those]
though: [though]
thought: [thought]
thought's: [thoughts]
thoughts: [thoughts]
thousand: [thou, sand]
thousand's: [thou, sands]
thousands: [thou, sands]
threat: [threat]
three: [three]
threw: [threw]
through: [through]
throughout: [throu, ghout]
throw: [throw]
throwing: [thro, wing]
thrown: [thrown]
throws: [throws]
thus: [thus]
ticket: [ti, cket]
ticket's: [ti, ckets]
tickets: [ti, ckets]
tie: [tie]
tie's: [ties]
tied: [tied]
ties: [ties]
tight: [tight]
till: [till]
time: [time]
time's: [ti, mes]
timed: [ti, med]
times: [ti, mes]
timing: [ti, ming]
tin: [tin]
title: [ti, tle]
title's: [ti, tles]
titles: [ti, tles]
to: [to]
today: [to, day]
together: [to, ge, ther]
token: [to, ken]
told: [told]
tomorrow: [to, mo, rrow]
tonight: [to, night]
too: [too]
took: [took]
tooth: [tooth]
tooth's: [tooths]
top: [top]
topic: [to, pic]
topic's: [to, pics]
topics: [to, pics]
total: [to, tal]
totally: [to, ta, lly]
touch: [touch]
touched: [tou, ched]
touches: [tou, ches]
touching: [tou, ching]
toward: [to, ward]
towards: [to, wards]
town: [town]
trace: [trace]
track: [track]
track's: [tracks]
tracks: [tracks]
traditional: [tra, di, tio, nal]
traffic: [tra, ffic]
train: [train]
trained: [trai, ned]
training: [trai, ning]
trains: [trains]
transfer: [tran, sfer]
transferred: [tran, sfe, rred]
transferring: [tran, sfe, rring]
transfers: [tran, sfers]
translate: [tran, slate]
translated: [tran, sla, ted]
translates: [tran, sla, tes]
translating: [tran, sla, ting]
translation: [tran, sla, tion]
transport: [tran, sport]
trap: [trap]
trapped: [tra, pped]
trapping: [tra, pping]
traps: [traps]
trash: [trash]
travel: [tra, vel]
treat: [treat]
treated: [trea, ted]
treating: [trea, ting]
treatment: [trea, tment]
treats: [treats]
tree: [tree]
tree's: [trees]
trees: [trees]
trial: [trial]
trick: [trick]
tried: [tried]
tries: [tries]
trip: [trip]
trivial: [tri, vial]
trouble: [trou, ble]
truck: [truck]
truck's: [trucks]
trucks: [trucks]
true: [true]
truly: [tru, ly]
trunk: [trunk]
trust: [trust]
trusted: [tru, sted]
trusting: [tru, sting]
trusts: [trusts]
truth: [truth]
try: [try]
try's: [trys]
trying: [trying]
tune: [tune]
turn: [turn]
turn's: [turns]
turned: [tur, ned]
turning: [tur, ning]
turns: [turns]
twelve: [twel, ve]
twenty: [twen, ty]
twice: [twice]
two: [two]
tying: [tying]
type: [ty, pe]
type's: [ty, pes]
typed: [ty, ped]
types: [ty, pes]
typical: [ty, pi, cal]
typing: [ty, ping]
ugly: [u, gly]
ultimate: [ul, ti, mate]
ultimately: [ul, ti, ma, te, ly]
unable: [u, na, ble]
unacceptable: [u, na, cce, pta, ble]
unaware: [u, na, ware]
uncertain: [un, cer, tain]
unclear: [un, clear]
under: [un, der]
undergraduate: [un, der, gra, duate]
undergraduate's: [un, der, gra, dua, tes]
undergraduates: [un, der, gra, dua, tes]
underneath: [un, der, neath]
understand: [un, der, stand]
understanding: [un, der, stan, ding]
understands: [un, der, stands]
understood: [un, der, stood]
unfortunate: [un, for, tu, nate]
unfortunately: [un, for, tu, na, te, ly]
unhappy: [un, ha, ppy]
uniform: [u, ni, form]
unique: [u, ni, que]
unit: [u, nit]
unit's: [u, nits]
unite: [u, nite]
units: [u, nits]
universal: [u, ni, ver, sal]
universities: [u, ni, ver, si, ties]
university: [u, ni, ver, si, ty]
university's: [u, ni, ver, si, tys]
unknown: [un, known]
unless: [u, nless]
unlike: [u, nlike]
unlikely: [u, nli, ke, ly]
unlimited: [u, nli, mi, ted]
unnecessarily: [u, nne, ce, ssa, ri, ly]
unnecessary: [u, nne, ce, ssa, ry]
unpleasant: [un, plea, sant]
unreasonable: [u, nrea, so, na, ble]
unsuitable: [un, sui, ta, ble]
until: [un, til]
unusual: [u, nu, sual]
unwanted: [u, nwan, ted]
up: [up]
update: [u, pdate]
updated: [u, pda, ted]
updates: [u, pda, tes]
updating: [u, pda, ting]
upon: [u, pon]
upper: [u, pper]
upset: [u, pset]
upsets: [u, psets]
upsetting: [u, pse, tting]
upwards: [u, pwards]
us: [us]
usage: [u, sage]
use: [use]
use's: [u, ses]
used: [u, sed]
useful: [u, se, ful]
useless: [u, se, less]
user: [u, ser]
user's: [u, sers]
users: [u, sers]
uses: [u, ses]
using: [u, sing]
usual: [u, sual]
usually: [u, sua, lly]
utility: [u, ti, li, ty]
utterly: [u, tter, ly]
vacation: [va, ca, tion]
vacation's: [va, ca, tions]
vacations: [va, ca, tions]
vague: [va, gue]
vaguely: [va, gue, ly]
valid: [va, lid]
validity: [va, li, di, ty]
valuable: [va, lua, ble]
value: [va, lue]
value's: [va, lues]
values: [va, lues]
van: [van]
vans: [vans]
variable: [va, ria, ble]
variable's: [va, ria, bles]
variables: [va, ria, bles]
variation: [va, ria, tion]
varied: [va, ried]
varies: [va, ries]
variety: [va, rie, ty]
various: [va, rious]
vary: [va, ry]
varying: [va, rying]
vast: [vast]
vastly: [va, stly]
vector: [ve, ctor]
version: [ver, sion]
version's: [ver, sions]
versions: [ver, sions]
very: [ve, ry]
via: [via]
vice: [vice]
video: [vi, deo]
view: [view]
view's: [views]
views: [views]
virtually: [vir, tua, lly]
virtue: [vir, tue]
visible: [vi, si, ble]
vision: [vi, sion]
visit: [vi, sit]
vital: [vi, tal]
voice: [voice]
volume: [vo, lume]
vote: [vote]
vote's: [vo, tes]
votes: [vo, tes]
wait: [wait]
waited: [wai, ted]
waiting: [wai, ting]
waits: [waits]
walk: [walk]
walked: [wal, ked]
walking: [wal, king]
walks: [walks]
wall: [wall]
wall's: [walls]
walls: [walls]
want: [want]
want's: [wants]
wanted: [wan, ted]
wanting: [wan, ting]
wants: [wants]
war: [war]
warm: [warm]
warn: [warn]
warned: [war, ned]
warning: [war, ning]
warns: [warns]
was: [was]
wash: [wash]
wasn't: [wasnt]
waste: [wa, ste]
wasted: [wa, sted]
wastes: [wa, stes]
wasting: [wa, sting]
watch: [watch]
watched: [wa, tched]
watches: [wa, tches]
watching: [wa, tching]
water: [wa, ter]
way: [way]
way's: [ways]
ways: [ways]
we: [we]
weapon: [wea, pon]
wear: [wear]
wearing: [wea, ring]
wears: [wears]
weather: [wea, ther]
week: [week]
week's: [weeks]
weekend: [wee, kend]
weeks: [weeks]
weight: [weight]
weird: [weird]
welcome: [wel, come]
welcomed: [wel, co, med]
welcomes: [wel, co, mes]
welcoming: [wel, co, ming]
well: [well]
went: [went]
were: [were]
west: [west]
western: [we, stern]
what: [what]
whatever: [wha, te, ver]
whatsoever: [wha, tsoe, ver]
wheel: [wheel]
wheel's: [wheels]
wheels: [wheels]
when: [when]
whenever: [whe, ne, ver]
where: [where]
whereas: [whe, reas]
whereby: [whe, re, by]
wherever: [whe, re, ver]
whether: [whe, ther]
which: [which]
while: [while]
whilst: [whilst]
white: [white]
who: [who]
whoever: [whoe, ver]
whole: [whole]
whom: [whom]
whose: [whose]
why: [why]
wide: [wide]
widely: [wi, de, ly]
wider: [wi, der]
widespread: [wi, de, spread]
widest: [wi, dest]
wife: [wife]
wild: [wild]
will: [will]
willed: [wi, lled]
willing: [wi, lling]
wills: [wills]
win: [win]
wind: [wind]
window: [win, dow]
window's: [win, dows]
windows: [win, dows]
wine: [wine]
winning: [wi, nning]
wins: [wins]
winter: [win, ter]
wire: [wire]
wise: [wise]
wish: [wish]
wish's: [wishs]
wished: [wi, shed]
wishes: [wi, shes]
wishing: [wi, shing]
with: [with]
withdraw: [with, draw]
within: [wi, thin]
without: [wi, thout]
woman: [wo, man]
woman's: [wo, mans]
women: [wo, men]
won: [won]
won's: [wons]
won't: [wont]
wonder: [won, der]
wondered: [won, de, red]
wonderful: [won, der, ful]
wondering: [won, de, ring]
wonders: [won, ders]
wooden: [woo, den]
word: [word]
word's: [words]
worded: [wor, ded]
wording: [wor, ding]
words: [words]
wore: [wore]
work: [work]
work's: [works]
worked: [wor, ked]
worker: [wor, ker]
worker's: [wor, kers]
workers: [wor, kers]
working: [wor, king]
works: [works]
world: [world]
worn: [worn]
worried: [wo, rried]
worries: [wo, rries]
worry: [wo, rry]
worrying: [wo, rrying]
worse: [wor, se]
worst: [worst]
worth: [worth]
worthwhile: [worth, while]
worthy: [wor, thy]
would: [would]
wouldn't: [wouldnt]
write: [ri]
writer: [ri, te]
writes: [ri, te]
writing: [ri, ti]
written: [ri, tte]
wrong: [ro]
wrote: [ro]
year: [year]
year's: [years]
years: [years]
yellow: [ye, llow]
yes: [yes]
yesterday: [ye, ster, day]
yet: [yet]
you: [you]
you're: [youre]
young: [young]
young's: [youngs]
your: [your]
yours: [yours]
yourself: [your, self]
zero: [ze, ro]
